revenue,expenses,profit,year,month,day,company,date
1332,727,605,1995,9,10,xyz,2024-09-10
6131,2903,3228,1995,9,11,xyz,2024-09-11
4042,4617,-575,1995,9,12,xyz,2024-09-12
8291,6376,1915,1995,9,13,xyz,2024-09-13
6767,8895,-2128,1995,9,14,xyz,2024-09-14
2840,6001,-3161,1995,9,15,xyz,2024-09-15
1143,7238,-6095,1995,9,16,xyz,2024-09-16
1750,4565,-2815,1995,9,17,xyz,2024-09-17
9509,976,8533,1995,9,18,xyz,2024-09-18
8643,7603,1040,1995,9,19,xyz,2024-09-19
6119,736,5383,1995,9,20,xyz,2024-09-20
6201,6772,-571,1995,9,21,xyz,2024-09-21
8884,8656,228,1995,9,22,xyz,2024-09-22
5655,5551,104,1995,9,23,xyz,2024-09-23
7831,7161,670,1995,9,24,xyz,2024-09-24
3757,7013,-3256,1995,9,25,xyz,2024-09-25
4165,4844,-679,1995,9,26,xyz,2024-09-26
6676,9063,-2387,1995,9,27,xyz,2024-09-27
5352,8433,-3081,1995,9,28,xyz,2024-09-28
9563,1924,7639,1995,9,29,xyz,2024-09-29
5057,1391,3666,1995,9,30,xyz,2024-09-30
8336,8020,316,1995,10,1,xyz,2024-10-01
5184,5314,-130,1995,10,2,xyz,2024-10-02
3482,8712,-5230,1995,10,3,xyz,2024-10-03
9018,7627,1391,1995,10,4,xyz,2024-10-04
9580,3375,6205,1995,10,5,xyz,2024-10-05
7451,3866,3585,1995,10,6,xyz,2024-10-06
1002,5736,-4734,1995,10,7,xyz,2024-10-07
4999,3427,1572,1995,10,8,xyz,2024-10-08
1106,1114,-8,1995,10,9,xyz,2024-10-09
7037,1667,5370,1995,10,10,xyz,2024-10-10
4670,5054,-384,1995,10,11,xyz,2024-10-11
4874,9016,-4142,1995,10,12,xyz,2024-10-12
9048,2207,6841,1995,10,13,xyz,2024-10-13
5909,8440,-2531,1995,10,14,xyz,2024-10-14
8447,2590,5857,1995,10,15,xyz,2024-10-15
3108,2976,132,1995,10,16,xyz,2024-10-16
9778,9998,-220,1995,10,17,xyz,2024-10-17
3403,4875,-1472,1995,10,18,xyz,2024-10-18
7749,5466,2283,1995,10,19,xyz,2024-10-19
2085,2869,-784,1995,10,20,xyz,2024-10-20
3987,621,3366,1995,10,21,xyz,2024-10-21
3639,3631,8,1995,10,22,xyz,2024-10-22
4190,7821,-3631,1995,10,23,xyz,2024-10-23
8951,4841,4110,1995,10,24,xyz,2024-10-24
2431,7238,-4807,1995,10,25,xyz,2024-10-25
1129,2989,-1860,1995,10,26,xyz,2024-10-26
3602,5229,-1627,1995,10,27,xyz,2024-10-27
2587,2423,164,1995,10,28,xyz,2024-10-28
2243,6568,-4325,1995,10,29,xyz,2024-10-29
7069,8385,-1316,1995,10,30,xyz,2024-10-30
2057,2124,-67,1995,10,31,xyz,2024-10-31
7686,2269,5417,1995,11,1,xyz,2024-11-01
5453,7319,-1866,1995,11,2,xyz,2024-11-02
1756,2419,-663,1995,11,3,xyz,2024-11-03
7188,6391,797,1995,11,4,xyz,2024-11-04
6668,2166,4502,1995,11,5,xyz,2024-11-05
6976,520,6456,1995,11,6,xyz,2024-11-06
2986,9745,-6759,1995,11,7,xyz,2024-11-07
7366,4223,3143,1995,11,8,xyz,2024-11-08
8003,8800,-797,1995,11,9,xyz,2024-11-09
1782,4128,-2346,1995,11,10,xyz,2024-11-10
7875,918,6957,1995,11,11,xyz,2024-11-11
8249,5879,2370,1995,11,12,xyz,2024-11-12
3864,8262,-4398,1995,11,13,xyz,2024-11-13
1472,7807,-6335,1995,11,14,xyz,2024-11-14
4728,3928,800,1995,11,15,xyz,2024-11-15
8907,826,8081,1995,11,16,xyz,2024-11-16
7444,7353,91,1995,11,17,xyz,2024-11-17
9404,7040,2364,1995,11,18,xyz,2024-11-18
7777,8202,-425,1995,11,19,xyz,2024-11-19
6584,4252,2332,1995,11,20,xyz,2024-11-20
2888,6814,-3926,1995,11,21,xyz,2024-11-21
8088,3514,4574,1995,11,22,xyz,2024-11-22
6165,6593,-428,1995,11,23,xyz,2024-11-23
2538,3002,-464,1995,11,24,xyz,2024-11-24
5865,1313,4552,1995,11,25,xyz,2024-11-25
1465,9380,-7915,1995,11,26,xyz,2024-11-26
3300,5360,-2060,1995,11,27,xyz,2024-11-27
3862,3725,137,1995,11,28,xyz,2024-11-28
6925,8936,-2011,1995,11,29,xyz,2024-11-29
4296,9474,-5178,1995,11,30,xyz,2024-11-30
1408,8415,-7007,1995,12,1,xyz,2024-12-01
9739,9578,161,1995,12,2,xyz,2024-12-02
4530,5019,-489,1995,12,3,xyz,2024-12-03
4453,1084,3369,1995,12,4,xyz,2024-12-04
1657,7736,-6079,1995,12,5,xyz,2024-12-05
7632,1859,5773,1995,12,6,xyz,2024-12-06
4277,7632,-3355,1995,12,7,xyz,2024-12-07
1321,7061,-5740,1995,12,8,xyz,2024-12-08
6326,6407,-81,1995,12,9,xyz,2024-12-09
7360,2291,5069,1995,12,10,xyz,2024-12-10
2935,1359,1576,1995,12,11,xyz,2024-12-11
2411,9027,-6616,1995,12,12,xyz,2024-12-12
8966,6248,2718,1995,12,13,xyz,2024-12-13
2504,1517,987,1995,12,14,xyz,2024-12-14
1568,581,987,1995,12,15,xyz,2024-12-15
3869,7058,-3189,1995,12,16,xyz,2024-12-16
5164,2919,2245,1995,12,17,xyz,2024-12-17
5277,7694,-2417,1995,12,18,xyz,2024-12-18
5042,5831,-789,1995,12,19,xyz,2024-12-19
6915,9633,-2718,1995,12,20,xyz,2024-12-20
9095,5446,3649,1995,12,21,xyz,2024-12-21
1100,7969,-6869,1995,12,22,xyz,2024-12-22
4011,3069,942,1995,12,23,xyz,2024-12-23
9422,8973,449,1995,12,24,xyz,2024-12-24
8595,1441,7154,1995,12,25,xyz,2024-12-25
8108,6806,1302,1995,12,26,xyz,2024-12-26
8030,6009,2021,1995,12,27,xyz,2024-12-27
2599,2863,-264,1995,12,28,xyz,2024-12-28
2971,5558,-2587,1995,12,29,xyz,2024-12-29
1584,7072,-5488,1995,12,30,xyz,2024-12-30
4984,5810,-826,1995,12,31,xyz,2024-12-31
3396,1331,2065,1996,1,1,xyz,2025-01-01
5074,3477,1597,1996,1,2,xyz,2025-01-02
7202,7298,-96,1996,1,3,xyz,2025-01-03
7086,1647,5439,1996,1,4,xyz,2025-01-04
7923,2444,5479,1996,1,5,xyz,2025-01-05
3156,2801,355,1996,1,6,xyz,2025-01-06
9724,1242,8482,1996,1,7,xyz,2025-01-07
5663,6299,-636,1996,1,8,xyz,2025-01-08
6974,3354,3620,1996,1,9,xyz,2025-01-09
3821,6121,-2300,1996,1,10,xyz,2025-01-10
6006,5393,613,1996,1,11,xyz,2025-01-11
9561,2300,7261,1996,1,12,xyz,2025-01-12
7802,5019,2783,1996,1,13,xyz,2025-01-13
9010,5190,3820,1996,1,14,xyz,2025-01-14
8059,679,7380,1996,1,15,xyz,2025-01-15
3467,3317,150,1996,1,16,xyz,2025-01-16
6592,3592,3000,1996,1,17,xyz,2025-01-17
2100,1122,978,1996,1,18,xyz,2025-01-18
7985,1915,6070,1996,1,19,xyz,2025-01-19
9912,7273,2639,1996,1,20,xyz,2025-01-20
7429,6385,1044,1996,1,21,xyz,2025-01-21
3636,8724,-5088,1996,1,22,xyz,2025-01-22
3787,3289,498,1996,1,23,xyz,2025-01-23
8996,2444,6552,1996,1,24,xyz,2025-01-24
7186,6481,705,1996,1,25,xyz,2025-01-25
2407,1730,677,1996,1,26,xyz,2025-01-26
3282,1514,1768,1996,1,27,xyz,2025-01-27
7038,6420,618,1996,1,28,xyz,2025-01-28
8868,6245,2623,1996,1,29,xyz,2025-01-29
9233,1809,7424,1996,1,30,xyz,2025-01-30
8773,4477,4296,1996,1,31,xyz,2025-01-31
8626,5929,2697,1996,2,1,xyz,2025-02-01
5373,5432,-59,1996,2,2,xyz,2025-02-02
6951,5351,1600,1996,2,3,xyz,2025-02-03
9909,6095,3814,1996,2,4,xyz,2025-02-04
4434,2130,2304,1996,2,5,xyz,2025-02-05
3362,1336,2026,1996,2,6,xyz,2025-02-06
4489,8202,-3713,1996,2,7,xyz,2025-02-07
3587,9752,-6165,1996,2,8,xyz,2025-02-08
5529,7937,-2408,1996,2,9,xyz,2025-02-09
2200,2378,-178,1996,2,10,xyz,2025-02-10
8885,2273,6612,1996,2,11,xyz,2025-02-11
8483,3746,4737,1996,2,12,xyz,2025-02-12
1493,3314,-1821,1996,2,13,xyz,2025-02-13
4312,4430,-118,1996,2,14,xyz,2025-02-14
7138,8297,-1159,1996,2,15,xyz,2025-02-15
3561,2471,1090,1996,2,16,xyz,2025-02-16
4958,2735,2223,1996,2,17,xyz,2025-02-17
4444,1661,2783,1996,2,18,xyz,2025-02-18
5786,6258,-472,1996,2,19,xyz,2025-02-19
8315,1750,6565,1996,2,20,xyz,2025-02-20
8272,1432,6840,1996,2,21,xyz,2025-02-21
9214,7795,1419,1996,2,22,xyz,2025-02-22
9471,4914,4557,1996,2,23,xyz,2025-02-23
9563,6045,3518,1996,2,24,xyz,2025-02-24
2049,9530,-7481,1996,2,25,xyz,2025-02-25
6813,9825,-3012,1996,2,26,xyz,2025-02-26
2635,4656,-2021,1996,2,27,xyz,2025-02-27
2988,2083,905,1996,2,28,xyz,2025-02-28
8960,7518,1442,1996,3,1,xyz,2025-03-01
2082,6471,-4389,1996,3,2,xyz,2025-03-02
8550,6104,2446,1996,3,3,xyz,2025-03-03
3420,9433,-6013,1996,3,4,xyz,2025-03-04
9747,3443,6304,1996,3,5,xyz,2025-03-05
7319,5189,2130,1996,3,6,xyz,2025-03-06
9885,682,9203,1996,3,7,xyz,2025-03-07
4926,9149,-4223,1996,3,8,xyz,2025-03-08
4884,7883,-2999,1996,3,9,xyz,2025-03-09
5533,1557,3976,1996,3,10,xyz,2025-03-10
8598,6340,2258,1996,3,11,xyz,2025-03-11
6194,8937,-2743,1996,3,12,xyz,2025-03-12
3658,514,3144,1996,3,13,xyz,2025-03-13
1367,3620,-2253,1996,3,14,xyz,2025-03-14
7165,2703,4462,1996,3,15,xyz,2025-03-15
8411,3908,4503,1996,3,16,xyz,2025-03-16
6330,4490,1840,1996,3,17,xyz,2025-03-17
6533,8817,-2284,1996,3,18,xyz,2025-03-18
8474,679,7795,1996,3,19,xyz,2025-03-19
2346,7096,-4750,1996,3,20,xyz,2025-03-20
7126,9672,-2546,1996,3,21,xyz,2025-03-21
6227,6517,-290,1996,3,22,xyz,2025-03-22
7811,2069,5742,1996,3,23,xyz,2025-03-23
7584,2724,4860,1996,3,24,xyz,2025-03-24
4763,2186,2577,1996,3,25,xyz,2025-03-25
8375,8598,-223,1996,3,26,xyz,2025-03-26
3126,9251,-6125,1996,3,27,xyz,2025-03-27
3595,5356,-1761,1996,3,28,xyz,2025-03-28
1530,4751,-3221,1996,3,29,xyz,2025-03-29
2101,1432,669,1996,3,30,xyz,2025-03-30
7132,5985,1147,1996,3,31,xyz,2025-03-31
1729,2352,-623,1996,4,1,xyz,2025-04-01
4259,9957,-5698,1996,4,2,xyz,2025-04-02
4065,3628,437,1996,4,3,xyz,2025-04-03
1838,6348,-4510,1996,4,4,xyz,2025-04-04
4284,8779,-4495,1996,4,5,xyz,2025-04-05
2848,9109,-6261,1996,4,6,xyz,2025-04-06
2721,5616,-2895,1996,4,7,xyz,2025-04-07
1846,6369,-4523,1996,4,8,xyz,2025-04-08
5295,2189,3106,1996,4,9,xyz,2025-04-09
7101,2009,5092,1996,4,10,xyz,2025-04-10
4158,4705,-547,1996,4,11,xyz,2025-04-11
6586,3656,2930,1996,4,12,xyz,2025-04-12
3990,729,3261,1996,4,13,xyz,2025-04-13
4696,7930,-3234,1996,4,14,xyz,2025-04-14
2879,8419,-5540,1996,4,15,xyz,2025-04-15
9245,2145,7100,1996,4,16,xyz,2025-04-16
1994,3579,-1585,1996,4,17,xyz,2025-04-17
6156,529,5627,1996,4,18,xyz,2025-04-18
7259,9550,-2291,1996,4,19,xyz,2025-04-19
7552,2869,4683,1996,4,20,xyz,2025-04-20
3412,1958,1454,1996,4,21,xyz,2025-04-21
7149,8192,-1043,1996,4,22,xyz,2025-04-22
6334,2983,3351,1996,4,23,xyz,2025-04-23
4154,7386,-3232,1996,4,24,xyz,2025-04-24
2623,9555,-6932,1996,4,25,xyz,2025-04-25
9018,6844,2174,1996,4,26,xyz,2025-04-26
8330,4774,3556,1996,4,27,xyz,2025-04-27
8906,8861,45,1996,4,28,xyz,2025-04-28
7175,2988,4187,1996,4,29,xyz,2025-04-29
3409,3794,-385,1996,4,30,xyz,2025-04-30
3104,7663,-4559,1996,5,1,xyz,2025-05-01
9498,4132,5366,1996,5,2,xyz,2025-05-02
3031,646,2385,1996,5,3,xyz,2025-05-03
7220,2620,4600,1996,5,4,xyz,2025-05-04
9423,2429,6994,1996,5,5,xyz,2025-05-05
5479,4575,904,1996,5,6,xyz,2025-05-06
9462,6877,2585,1996,5,7,xyz,2025-05-07
6179,5315,864,1996,5,8,xyz,2025-05-08
2638,3441,-803,1996,5,9,xyz,2025-05-09
9321,6225,3096,1996,5,10,xyz,2025-05-10
2563,1785,778,1996,5,11,xyz,2025-05-11
1143,8604,-7461,1996,5,12,xyz,2025-05-12
4455,1269,3186,1996,5,13,xyz,2025-05-13
7422,5622,1800,1996,5,14,xyz,2025-05-14
4295,5899,-1604,1996,5,15,xyz,2025-05-15
9468,6049,3419,1996,5,16,xyz,2025-05-16
4137,5951,-1814,1996,5,17,xyz,2025-05-17
7523,6916,607,1996,5,18,xyz,2025-05-18
7964,3644,4320,1996,5,19,xyz,2025-05-19
1411,5386,-3975,1996,5,20,xyz,2025-05-20
4368,9447,-5079,1996,5,21,xyz,2025-05-21
3313,6673,-3360,1996,5,22,xyz,2025-05-22
5633,5929,-296,1996,5,23,xyz,2025-05-23
9133,9223,-90,1996,5,24,xyz,2025-05-24
2287,7702,-5415,1996,5,25,xyz,2025-05-25
5257,6289,-1032,1996,5,26,xyz,2025-05-26
8205,6567,1638,1996,5,27,xyz,2025-05-27
4584,8727,-4143,1996,5,28,xyz,2025-05-28
3310,3790,-480,1996,5,29,xyz,2025-05-29
5963,8741,-2778,1996,5,30,xyz,2025-05-30
5900,3072,2828,1996,5,31,xyz,2025-05-31
2401,2166,235,1996,6,1,xyz,2025-06-01
9057,1958,7099,1996,6,2,xyz,2025-06-02
7077,2980,4097,1996,6,3,xyz,2025-06-03
3736,6272,-2536,1996,6,4,xyz,2025-06-04
1505,1529,-24,1996,6,5,xyz,2025-06-05
2178,4867,-2689,1996,6,6,xyz,2025-06-06
7947,9358,-1411,1996,6,7,xyz,2025-06-07
7863,9909,-2046,1996,6,8,xyz,2025-06-08
8169,1234,6935,1996,6,9,xyz,2025-06-09
2538,501,2037,1996,6,10,xyz,2025-06-10
3634,2785,849,1996,6,11,xyz,2025-06-11
1698,1072,626,1996,6,12,xyz,2025-06-12
6628,3298,3330,1996,6,13,xyz,2025-06-13
5016,9139,-4123,1996,6,14,xyz,2025-06-14
5355,7146,-1791,1996,6,15,xyz,2025-06-15
7485,8794,-1309,1996,6,16,xyz,2025-06-16
1470,1508,-38,1996,6,17,xyz,2025-06-17
8775,9738,-963,1996,6,18,xyz,2025-06-18
9969,1607,8362,1996,6,19,xyz,2025-06-19
2766,780,1986,1996,6,20,xyz,2025-06-20
3558,585,2973,1996,6,21,xyz,2025-06-21
3207,7116,-3909,1996,6,22,xyz,2025-06-22
8478,5898,2580,1996,6,23,xyz,2025-06-23
3552,9313,-5761,1996,6,24,xyz,2025-06-24
8460,1802,6658,1996,6,25,xyz,2025-06-25
7436,4349,3087,1996,6,26,xyz,2025-06-26
1457,7836,-6379,1996,6,27,xyz,2025-06-27
6032,7608,-1576,1996,6,28,xyz,2025-06-28
1413,1587,-174,1996,6,29,xyz,2025-06-29
7936,8708,-772,1996,6,30,xyz,2025-06-30
4365,6659,-2294,1996,7,1,xyz,2025-07-01
1841,6198,-4357,1996,7,2,xyz,2025-07-02
5003,5193,-190,1996,7,3,xyz,2025-07-03
2536,6967,-4431,1996,7,4,xyz,2025-07-04
6458,4957,1501,1996,7,5,xyz,2025-07-05
6568,4294,2274,1996,7,6,xyz,2025-07-06
3397,2185,1212,1996,7,7,xyz,2025-07-07
2283,6118,-3835,1996,7,8,xyz,2025-07-08
9889,9509,380,1996,7,9,xyz,2025-07-09
2765,5144,-2379,1996,7,10,xyz,2025-07-10
2639,3221,-582,1996,7,11,xyz,2025-07-11
5712,2844,2868,1996,7,12,xyz,2025-07-12
5984,9416,-3432,1996,7,13,xyz,2025-07-13
3759,6636,-2877,1996,7,14,xyz,2025-07-14
7451,7194,257,1996,7,15,xyz,2025-07-15
3997,3215,782,1996,7,16,xyz,2025-07-16
8033,5595,2438,1996,7,17,xyz,2025-07-17
5445,8972,-3527,1996,7,18,xyz,2025-07-18
1256,4636,-3380,1996,7,19,xyz,2025-07-19
1569,1013,556,1996,7,20,xyz,2025-07-20
2844,2576,268,1996,7,21,xyz,2025-07-21
7573,3995,3578,1996,7,22,xyz,2025-07-22
2315,7513,-5198,1996,7,23,xyz,2025-07-23
6571,5134,1437,1996,7,24,xyz,2025-07-24
3337,3853,-516,1996,7,25,xyz,2025-07-25
3979,4895,-916,1996,7,26,xyz,2025-07-26
5367,8604,-3237,1996,7,27,xyz,2025-07-27
2169,9489,-7320,1996,7,28,xyz,2025-07-28
1644,1140,504,1996,7,29,xyz,2025-07-29
4763,6367,-1604,1996,7,30,xyz,2025-07-30
5855,2854,3001,1996,7,31,xyz,2025-07-31
2703,6621,-3918,1996,8,1,xyz,2025-08-01
6139,7561,-1422,1996,8,2,xyz,2025-08-02
2887,8259,-5372,1996,8,3,xyz,2025-08-03
1174,4532,-3358,1996,8,4,xyz,2025-08-04
2561,8579,-6018,1996,8,5,xyz,2025-08-05
1943,680,1263,1996,8,6,xyz,2025-08-06
5042,4876,166,1996,8,7,xyz,2025-08-07
3210,7868,-4658,1996,8,8,xyz,2025-08-08
6046,7458,-1412,1996,8,9,xyz,2025-08-09
4315,652,3663,1996,8,10,xyz,2025-08-10
7391,834,6557,1996,8,11,xyz,2025-08-11
5684,8087,-2403,1996,8,12,xyz,2025-08-12
4660,4006,654,1996,8,13,xyz,2025-08-13
8794,8114,680,1996,8,14,xyz,2025-08-14
1309,7455,-6146,1996,8,15,xyz,2025-08-15
1160,4092,-2932,1996,8,16,xyz,2025-08-16
5386,1005,4381,1996,8,17,xyz,2025-08-17
2924,6543,-3619,1996,8,18,xyz,2025-08-18
8778,9144,-366,1996,8,19,xyz,2025-08-19
3075,2219,856,1996,8,20,xyz,2025-08-20
4758,6961,-2203,1996,8,21,xyz,2025-08-21
9491,5292,4199,1996,8,22,xyz,2025-08-22
8483,5270,3213,1996,8,23,xyz,2025-08-23
3284,6950,-3666,1996,8,24,xyz,2025-08-24
6670,4190,2480,1996,8,25,xyz,2025-08-25
7403,2619,4784,1996,8,26,xyz,2025-08-26
7766,4929,2837,1996,8,27,xyz,2025-08-27
2455,8847,-6392,1996,8,28,xyz,2025-08-28
2262,1188,1074,1996,8,29,xyz,2025-08-29
5917,9352,-3435,1996,8,30,xyz,2025-08-30
1416,5607,-4191,1996,8,31,xyz,2025-08-31
8930,1456,7474,1996,9,1,xyz,2025-09-01
3809,7231,-3422,1996,9,2,xyz,2025-09-02
8612,6770,1842,1996,9,3,xyz,2025-09-03
4412,9938,-5526,1996,9,4,xyz,2025-09-04
5720,4311,1409,1996,9,5,xyz,2025-09-05
6294,5351,943,1996,9,6,xyz,2025-09-06
4303,8059,-3756,1996,9,7,xyz,2025-09-07
9633,1653,7980,1996,9,8,xyz,2025-09-08
6399,8442,-2043,1996,9,9,xyz,2025-09-09
8693,6886,1807,1996,9,10,xyz,2025-09-10
6795,2336,4459,1996,9,11,xyz,2025-09-11
6171,4597,1574,1996,9,12,xyz,2025-09-12
6100,7965,-1865,1996,9,13,xyz,2025-09-13
8051,994,7057,1996,9,14,xyz,2025-09-14
8307,4637,3670,1996,9,15,xyz,2025-09-15
1777,3825,-2048,1996,9,16,xyz,2025-09-16
2627,9877,-7250,1996,9,17,xyz,2025-09-17
6828,2422,4406,1996,9,18,xyz,2025-09-18
2483,3649,-1166,1996,9,19,xyz,2025-09-19
6525,5309,1216,1996,9,20,xyz,2025-09-20
6411,1327,5084,1996,9,21,xyz,2025-09-21
2989,1828,1161,1996,9,22,xyz,2025-09-22
3477,5932,-2455,1996,9,23,xyz,2025-09-23
6165,2321,3844,1996,9,24,xyz,2025-09-24
1160,3726,-2566,1996,9,25,xyz,2025-09-25
1478,5516,-4038,1996,9,26,xyz,2025-09-26
8023,3259,4764,1996,9,27,xyz,2025-09-27
9044,4933,4111,1996,9,28,xyz,2025-09-28
7448,7764,-316,1996,9,29,xyz,2025-09-29
5646,7996,-2350,1996,9,30,xyz,2025-09-30
7953,3368,4585,1996,10,1,xyz,2025-10-01
4861,9612,-4751,1996,10,2,xyz,2025-10-02
5256,3128,2128,1996,10,3,xyz,2025-10-03
5265,3325,1940,1996,10,4,xyz,2025-10-04
5098,2878,2220,1996,10,5,xyz,2025-10-05
5586,3006,2580,1996,10,6,xyz,2025-10-06
2152,8824,-6672,1996,10,7,xyz,2025-10-07
7491,1645,5846,1996,10,8,xyz,2025-10-08
2342,8469,-6127,1996,10,9,xyz,2025-10-09
4849,5494,-645,1996,10,10,xyz,2025-10-10
9702,6574,3128,1996,10,11,xyz,2025-10-11
4752,7090,-2338,1996,10,12,xyz,2025-10-12
8977,6670,2307,1996,10,13,xyz,2025-10-13
3513,3844,-331,1996,10,14,xyz,2025-10-14
6131,1839,4292,1996,10,15,xyz,2025-10-15
3079,3084,-5,1996,10,16,xyz,2025-10-16
5732,9296,-3564,1996,10,17,xyz,2025-10-17
1139,2848,-1709,1996,10,18,xyz,2025-10-18
6255,911,5344,1996,10,19,xyz,2025-10-19
2588,7896,-5308,1996,10,20,xyz,2025-10-20
3917,9457,-5540,1996,10,21,xyz,2025-10-21
5579,7686,-2107,1996,10,22,xyz,2025-10-22
2002,2511,-509,1996,10,23,xyz,2025-10-23
4014,9420,-5406,1996,10,24,xyz,2025-10-24
6310,1002,5308,1996,10,25,xyz,2025-10-25
6944,1320,5624,1996,10,26,xyz,2025-10-26
8284,9508,-1224,1996,10,27,xyz,2025-10-27
7119,9989,-2870,1996,10,28,xyz,2025-10-28
9131,4184,4947,1996,10,29,xyz,2025-10-29
2320,6657,-4337,1996,10,30,xyz,2025-10-30
5412,1454,3958,1996,10,31,xyz,2025-10-31
2249,3785,-1536,1996,11,1,xyz,2025-11-01
7463,4981,2482,1996,11,2,xyz,2025-11-02
1239,6822,-5583,1996,11,3,xyz,2025-11-03
8701,5946,2755,1996,11,4,xyz,2025-11-04
1578,1413,165,1996,11,5,xyz,2025-11-05
5294,6748,-1454,1996,11,6,xyz,2025-11-06
1348,656,692,1996,11,7,xyz,2025-11-07
7623,1372,6251,1996,11,8,xyz,2025-11-08
6214,5226,988,1996,11,9,xyz,2025-11-09
8311,6021,2290,1996,11,10,xyz,2025-11-10
8781,3989,4792,1996,11,11,xyz,2025-11-11
3962,3606,356,1996,11,12,xyz,2025-11-12
9935,7148,2787,1996,11,13,xyz,2025-11-13
9984,3980,6004,1996,11,14,xyz,2025-11-14
7298,8909,-1611,1996,11,15,xyz,2025-11-15
5783,7266,-1483,1996,11,16,xyz,2025-11-16
3849,4637,-788,1996,11,17,xyz,2025-11-17
4216,2873,1343,1996,11,18,xyz,2025-11-18
7162,3397,3765,1996,11,19,xyz,2025-11-19
6312,7623,-1311,1996,11,20,xyz,2025-11-20
3523,5888,-2365,1996,11,21,xyz,2025-11-21
1808,1725,83,1996,11,22,xyz,2025-11-22
3941,6886,-2945,1996,11,23,xyz,2025-11-23
5856,3859,1997,1996,11,24,xyz,2025-11-24
6052,7936,-1884,1996,11,25,xyz,2025-11-25
8851,7442,1409,1996,11,26,xyz,2025-11-26
4651,2827,1824,1996,11,27,xyz,2025-11-27
8902,5544,3358,1996,11,28,xyz,2025-11-28
1764,3646,-1882,1996,11,29,xyz,2025-11-29
8036,8459,-423,1996,11,30,xyz,2025-11-30
4445,961,3484,1996,12,1,xyz,2025-12-01
7335,4505,2830,1996,12,2,xyz,2025-12-02
3206,1161,2045,1996,12,3,xyz,2025-12-03
9413,3060,6353,1996,12,4,xyz,2025-12-04
2325,3707,-1382,1996,12,5,xyz,2025-12-05
5074,2102,2972,1996,12,6,xyz,2025-12-06
3788,4204,-416,1996,12,7,xyz,2025-12-07
3072,2789,283,1996,12,8,xyz,2025-12-08
7297,1060,6237,1996,12,9,xyz,2025-12-09
8327,6123,2204,1996,12,10,xyz,2025-12-10
9900,6001,3899,1996,12,11,xyz,2025-12-11
7771,9550,-1779,1996,12,12,xyz,2025-12-12
3565,1730,1835,1996,12,13,xyz,2025-12-13
4623,3382,1241,1996,12,14,xyz,2025-12-14
7871,9256,-1385,1996,12,15,xyz,2025-12-15
9380,3084,6296,1996,12,16,xyz,2025-12-16
4909,4508,401,1996,12,17,xyz,2025-12-17
3891,9556,-5665,1996,12,18,xyz,2025-12-18
7658,6437,1221,1996,12,19,xyz,2025-12-19
4706,5633,-927,1996,12,20,xyz,2025-12-20
3361,4234,-873,1996,12,21,xyz,2025-12-21
3350,7694,-4344,1996,12,22,xyz,2025-12-22
9837,3883,5954,1996,12,23,xyz,2025-12-23
2532,3415,-883,1996,12,24,xyz,2025-12-24
1113,4535,-3422,1996,12,25,xyz,2025-12-25
8127,1287,6840,1996,12,26,xyz,2025-12-26
9440,2604,6836,1996,12,27,xyz,2025-12-27
5995,9056,-3061,1996,12,28,xyz,2025-12-28
1623,4761,-3138,1996,12,29,xyz,2025-12-29
7401,6434,967,1996,12,30,xyz,2025-12-30
2700,3397,-697,1996,12,31,xyz,2025-12-31
1293,2681,-1388,1997,1,1,xyz,2026-01-01
8623,5781,2842,1997,1,2,xyz,2026-01-02
6684,2907,3777,1997,1,3,xyz,2026-01-03
7401,6492,909,1997,1,4,xyz,2026-01-04
6527,1535,4992,1997,1,5,xyz,2026-01-05
9573,2560,7013,1997,1,6,xyz,2026-01-06
6703,4034,2669,1997,1,7,xyz,2026-01-07
5116,1761,3355,1997,1,8,xyz,2026-01-08
7447,8086,-639,1997,1,9,xyz,2026-01-09
2201,4269,-2068,1997,1,10,xyz,2026-01-10
7903,1116,6787,1997,1,11,xyz,2026-01-11
3646,7727,-4081,1997,1,12,xyz,2026-01-12
1034,1472,-438,1997,1,13,xyz,2026-01-13
3823,8898,-5075,1997,1,14,xyz,2026-01-14
1754,3930,-2176,1997,1,15,xyz,2026-01-15
6850,3053,3797,1997,1,16,xyz,2026-01-16
7476,5834,1642,1997,1,17,xyz,2026-01-17
6233,9802,-3569,1997,1,18,xyz,2026-01-18
8599,9531,-932,1997,1,19,xyz,2026-01-19
1824,9828,-8004,1997,1,20,xyz,2026-01-20
3182,3592,-410,1997,1,21,xyz,2026-01-21
3597,8759,-5162,1997,1,22,xyz,2026-01-22
5779,1503,4276,1997,1,23,xyz,2026-01-23
6521,5550,971,1997,1,24,xyz,2026-01-24
4634,9534,-4900,1997,1,25,xyz,2026-01-25
6408,6233,175,1997,1,26,xyz,2026-01-26
4478,2748,1730,1997,1,27,xyz,2026-01-27
4146,2660,1486,1997,1,28,xyz,2026-01-28
7187,4513,2674,1997,1,29,xyz,2026-01-29
4316,8595,-4279,1997,1,30,xyz,2026-01-30
2465,3406,-941,1997,1,31,xyz,2026-01-31
3129,2440,689,1997,2,1,xyz,2026-02-01
5417,2257,3160,1997,2,2,xyz,2026-02-02
8760,5524,3236,1997,2,3,xyz,2026-02-03
2594,2364,230,1997,2,4,xyz,2026-02-04
9299,8357,942,1997,2,5,xyz,2026-02-05
7689,5920,1769,1997,2,6,xyz,2026-02-06
7047,1400,5647,1997,2,7,xyz,2026-02-07
5550,2474,3076,1997,2,8,xyz,2026-02-08
6118,522,5596,1997,2,9,xyz,2026-02-09
6638,7951,-1313,1997,2,10,xyz,2026-02-10
8529,6236,2293,1997,2,11,xyz,2026-02-11
8464,4454,4010,1997,2,12,xyz,2026-02-12
2403,9852,-7449,1997,2,13,xyz,2026-02-13
6834,2318,4516,1997,2,14,xyz,2026-02-14
6400,7210,-810,1997,2,15,xyz,2026-02-15
5565,3739,1826,1997,2,16,xyz,2026-02-16
8570,1963,6607,1997,2,17,xyz,2026-02-17
2421,9186,-6765,1997,2,18,xyz,2026-02-18
7127,9716,-2589,1997,2,19,xyz,2026-02-19
1434,1207,227,1997,2,20,xyz,2026-02-20
6501,7725,-1224,1997,2,21,xyz,2026-02-21
1815,4645,-2830,1997,2,22,xyz,2026-02-22
5693,4648,1045,1997,2,23,xyz,2026-02-23
8070,6117,1953,1997,2,24,xyz,2026-02-24
9828,5648,4180,1997,2,25,xyz,2026-02-25
6339,8450,-2111,1997,2,26,xyz,2026-02-26
7028,4696,2332,1997,2,27,xyz,2026-02-27
1601,8563,-6962,1997,2,28,xyz,2026-02-28
7432,8562,-1130,1997,3,1,xyz,2026-03-01
6032,5693,339,1997,3,2,xyz,2026-03-02
9473,4599,4874,1997,3,3,xyz,2026-03-03
8044,8409,-365,1997,3,4,xyz,2026-03-04
6531,2658,3873,1997,3,5,xyz,2026-03-05
3871,7814,-3943,1997,3,6,xyz,2026-03-06
1855,5995,-4140,1997,3,7,xyz,2026-03-07
5958,711,5247,1997,3,8,xyz,2026-03-08
8762,7935,827,1997,3,9,xyz,2026-03-09
8539,1990,6549,1997,3,10,xyz,2026-03-10
3608,2049,1559,1997,3,11,xyz,2026-03-11
7401,2951,4450,1997,3,12,xyz,2026-03-12
5164,1202,3962,1997,3,13,xyz,2026-03-13
7058,4784,2274,1997,3,14,xyz,2026-03-14
6576,2623,3953,1997,3,15,xyz,2026-03-15
9143,1451,7692,1997,3,16,xyz,2026-03-16
5458,7808,-2350,1997,3,17,xyz,2026-03-17
9124,9072,52,1997,3,18,xyz,2026-03-18
4340,987,3353,1997,3,19,xyz,2026-03-19
1864,7763,-5899,1997,3,20,xyz,2026-03-20
1755,6053,-4298,1997,3,21,xyz,2026-03-21
7799,6886,913,1997,3,22,xyz,2026-03-22
7665,6843,822,1997,3,23,xyz,2026-03-23
7380,2378,5002,1997,3,24,xyz,2026-03-24
7264,3888,3376,1997,3,25,xyz,2026-03-25
5592,5082,510,1997,3,26,xyz,2026-03-26
7607,8364,-757,1997,3,27,xyz,2026-03-27
6965,8730,-1765,1997,3,28,xyz,2026-03-28
8747,8043,704,1997,3,29,xyz,2026-03-29
1377,2022,-645,1997,3,30,xyz,2026-03-30
3007,8469,-5462,1997,3,31,xyz,2026-03-31
9758,5504,4254,1997,4,1,xyz,2026-04-01
9129,9210,-81,1997,4,2,xyz,2026-04-02
4442,2177,2265,1997,4,3,xyz,2026-04-03
7627,5640,1987,1997,4,4,xyz,2026-04-04
7627,767,6860,1997,4,5,xyz,2026-04-05
5839,9461,-3622,1997,4,6,xyz,2026-04-06
2761,6102,-3341,1997,4,7,xyz,2026-04-07
9629,4827,4802,1997,4,8,xyz,2026-04-08
5138,9516,-4378,1997,4,9,xyz,2026-04-09
8599,7527,1072,1997,4,10,xyz,2026-04-10
7334,6914,420,1997,4,11,xyz,2026-04-11
8352,9821,-1469,1997,4,12,xyz,2026-04-12
3881,2146,1735,1997,4,13,xyz,2026-04-13
5356,7605,-2249,1997,4,14,xyz,2026-04-14
2997,5515,-2518,1997,4,15,xyz,2026-04-15
9700,7930,1770,1997,4,16,xyz,2026-04-16
3939,1378,2561,1997,4,17,xyz,2026-04-17
1880,4514,-2634,1997,4,18,xyz,2026-04-18
5659,5761,-102,1997,4,19,xyz,2026-04-19
3899,2932,967,1997,4,20,xyz,2026-04-20
7980,2365,5615,1997,4,21,xyz,2026-04-21
4327,505,3822,1997,4,22,xyz,2026-04-22
7917,6838,1079,1997,4,23,xyz,2026-04-23
6122,3516,2606,1997,4,24,xyz,2026-04-24
6302,2143,4159,1997,4,25,xyz,2026-04-25
7935,7909,26,1997,4,26,xyz,2026-04-26
1007,5599,-4592,1997,4,27,xyz,2026-04-27
1538,2448,-910,1997,4,28,xyz,2026-04-28
4046,4876,-830,1997,4,29,xyz,2026-04-29
1823,7931,-6108,1997,4,30,xyz,2026-04-30
1348,4031,-2683,1997,5,1,xyz,2026-05-01
4647,3098,1549,1997,5,2,xyz,2026-05-02
6843,3732,3111,1997,5,3,xyz,2026-05-03
9958,6364,3594,1997,5,4,xyz,2026-05-04
7718,7552,166,1997,5,5,xyz,2026-05-05
1362,868,494,1997,5,6,xyz,2026-05-06
9539,6386,3153,1997,5,7,xyz,2026-05-07
3476,9411,-5935,1997,5,8,xyz,2026-05-08
1839,9363,-7524,1997,5,9,xyz,2026-05-09
4863,7907,-3044,1997,5,10,xyz,2026-05-10
2732,2939,-207,1997,5,11,xyz,2026-05-11
5361,1355,4006,1997,5,12,xyz,2026-05-12
5586,2193,3393,1997,5,13,xyz,2026-05-13
8338,1396,6942,1997,5,14,xyz,2026-05-14
9630,6749,2881,1997,5,15,xyz,2026-05-15
2875,6724,-3849,1997,5,16,xyz,2026-05-16
6787,8286,-1499,1997,5,17,xyz,2026-05-17
5809,2309,3500,1997,5,18,xyz,2026-05-18
1053,3435,-2382,1997,5,19,xyz,2026-05-19
9862,9156,706,1997,5,20,xyz,2026-05-20
7196,8310,-1114,1997,5,21,xyz,2026-05-21
7961,6120,1841,1997,5,22,xyz,2026-05-22
6350,8054,-1704,1997,5,23,xyz,2026-05-23
1742,5482,-3740,1997,5,24,xyz,2026-05-24
8625,1157,7468,1997,5,25,xyz,2026-05-25
7583,3681,3902,1997,5,26,xyz,2026-05-26
4540,9173,-4633,1997,5,27,xyz,2026-05-27
6651,9575,-2924,1997,5,28,xyz,2026-05-28
2726,1156,1570,1997,5,29,xyz,2026-05-29
9815,8237,1578,1997,5,30,xyz,2026-05-30
8749,8846,-97,1997,5,31,xyz,2026-05-31
2775,8794,-6019,1997,6,1,xyz,2026-06-01
5229,8479,-3250,1997,6,2,xyz,2026-06-02
1617,4959,-3342,1997,6,3,xyz,2026-06-03
3645,5010,-1365,1997,6,4,xyz,2026-06-04
7816,4014,3802,1997,6,5,xyz,2026-06-05
7602,1941,5661,1997,6,6,xyz,2026-06-06
5424,4041,1383,1997,6,7,xyz,2026-06-07
9148,4270,4878,1997,6,8,xyz,2026-06-08
9823,804,9019,1997,6,9,xyz,2026-06-09
5602,6429,-827,1997,6,10,xyz,2026-06-10
4193,4139,54,1997,6,11,xyz,2026-06-11
1909,9770,-7861,1997,6,12,xyz,2026-06-12
3403,4598,-1195,1997,6,13,xyz,2026-06-13
3613,544,3069,1997,6,14,xyz,2026-06-14
9077,1655,7422,1997,6,15,xyz,2026-06-15
3460,1215,2245,1997,6,16,xyz,2026-06-16
7208,7131,77,1997,6,17,xyz,2026-06-17
8940,875,8065,1997,6,18,xyz,2026-06-18
7104,7476,-372,1997,6,19,xyz,2026-06-19
4898,913,3985,1997,6,20,xyz,2026-06-20
1738,1189,549,1997,6,21,xyz,2026-06-21
7346,8330,-984,1997,6,22,xyz,2026-06-22
6632,682,5950,1997,6,23,xyz,2026-06-23
7304,3373,3931,1997,6,24,xyz,2026-06-24
8609,1772,6837,1997,6,25,xyz,2026-06-25
2004,5889,-3885,1997,6,26,xyz,2026-06-26
5614,6429,-815,1997,6,27,xyz,2026-06-27
3653,4778,-1125,1997,6,28,xyz,2026-06-28
9399,3485,5914,1997,6,29,xyz,2026-06-29
2946,6548,-3602,1997,6,30,xyz,2026-06-30
4885,2379,2506,1997,7,1,xyz,2026-07-01
8688,5702,2986,1997,7,2,xyz,2026-07-02
7421,2961,4460,1997,7,3,xyz,2026-07-03
5964,2784,3180,1997,7,4,xyz,2026-07-04
4212,8883,-4671,1997,7,5,xyz,2026-07-05
4955,6177,-1222,1997,7,6,xyz,2026-07-06
3490,2562,928,1997,7,7,xyz,2026-07-07
3734,7677,-3943,1997,7,8,xyz,2026-07-08
4754,4324,430,1997,7,9,xyz,2026-07-09
5825,3773,2052,1997,7,10,xyz,2026-07-10
6291,5815,476,1997,7,11,xyz,2026-07-11
3187,2794,393,1997,7,12,xyz,2026-07-12
1147,7983,-6836,1997,7,13,xyz,2026-07-13
2443,8823,-6380,1997,7,14,xyz,2026-07-14
6309,7078,-769,1997,7,15,xyz,2026-07-15
8668,7998,670,1997,7,16,xyz,2026-07-16
1960,8423,-6463,1997,7,17,xyz,2026-07-17
5628,8596,-2968,1997,7,18,xyz,2026-07-18
5763,8206,-2443,1997,7,19,xyz,2026-07-19
3321,1664,1657,1997,7,20,xyz,2026-07-20
2119,871,1248,1997,7,21,xyz,2026-07-21
3482,926,2556,1997,7,22,xyz,2026-07-22
4120,2911,1209,1997,7,23,xyz,2026-07-23
1028,5511,-4483,1997,7,24,xyz,2026-07-24
1576,9958,-8382,1997,7,25,xyz,2026-07-25
1508,5289,-3781,1997,7,26,xyz,2026-07-26
5919,8845,-2926,1997,7,27,xyz,2026-07-27
4522,620,3902,1997,7,28,xyz,2026-07-28
5102,6302,-1200,1997,7,29,xyz,2026-07-29
1971,2696,-725,1997,7,30,xyz,2026-07-30
2280,1934,346,1997,7,31,xyz,2026-07-31
4814,7103,-2289,1997,8,1,xyz,2026-08-01
3209,1597,1612,1997,8,2,xyz,2026-08-02
9830,4900,4930,1997,8,3,xyz,2026-08-03
1759,8601,-6842,1997,8,4,xyz,2026-08-04
6521,8371,-1850,1997,8,5,xyz,2026-08-05
3837,1712,2125,1997,8,6,xyz,2026-08-06
9766,2807,6959,1997,8,7,xyz,2026-08-07
6450,6710,-260,1997,8,8,xyz,2026-08-08
4977,9649,-4672,1997,8,9,xyz,2026-08-09
2245,5519,-3274,1997,8,10,xyz,2026-08-10
3272,7059,-3787,1997,8,11,xyz,2026-08-11
6200,7902,-1702,1997,8,12,xyz,2026-08-12
6827,4241,2586,1997,8,13,xyz,2026-08-13
7765,6435,1330,1997,8,14,xyz,2026-08-14
6407,1158,5249,1997,8,15,xyz,2026-08-15
4510,2559,1951,1997,8,16,xyz,2026-08-16
6370,8528,-2158,1997,8,17,xyz,2026-08-17
8199,5176,3023,1997,8,18,xyz,2026-08-18
6283,6430,-147,1997,8,19,xyz,2026-08-19
6632,6607,25,1997,8,20,xyz,2026-08-20
9841,5603,4238,1997,8,21,xyz,2026-08-21
9329,4672,4657,1997,8,22,xyz,2026-08-22
4839,1743,3096,1997,8,23,xyz,2026-08-23
4737,6890,-2153,1997,8,24,xyz,2026-08-24
9764,2721,7043,1997,8,25,xyz,2026-08-25
9831,6984,2847,1997,8,26,xyz,2026-08-26
7317,1400,5917,1997,8,27,xyz,2026-08-27
2832,4703,-1871,1997,8,28,xyz,2026-08-28
9845,5664,4181,1997,8,29,xyz,2026-08-29
7808,5618,2190,1997,8,30,xyz,2026-08-30
3345,9596,-6251,1997,8,31,xyz,2026-08-31
4247,8506,-4259,1997,9,1,xyz,2026-09-01
2800,2826,-26,1997,9,2,xyz,2026-09-02
6340,7037,-697,1997,9,3,xyz,2026-09-03
6280,6728,-448,1997,9,4,xyz,2026-09-04
2710,4360,-1650,1997,9,5,xyz,2026-09-05
6629,3785,2844,1997,9,6,xyz,2026-09-06
3930,1581,2349,1997,9,7,xyz,2026-09-07
6201,5876,325,1997,9,8,xyz,2026-09-08
5673,1465,4208,1997,9,9,xyz,2026-09-09
7766,7279,487,1997,9,10,xyz,2026-09-10
5534,5005,529,1997,9,11,xyz,2026-09-11
2732,8055,-5323,1997,9,12,xyz,2026-09-12
8000,2825,5175,1997,9,13,xyz,2026-09-13
3199,7674,-4475,1997,9,14,xyz,2026-09-14
4369,3282,1087,1997,9,15,xyz,2026-09-15
5301,3532,1769,1997,9,16,xyz,2026-09-16
9356,2716,6640,1997,9,17,xyz,2026-09-17
1982,2360,-378,1997,9,18,xyz,2026-09-18
3748,8150,-4402,1997,9,19,xyz,2026-09-19
7680,3620,4060,1997,9,20,xyz,2026-09-20
5663,8515,-2852,1997,9,21,xyz,2026-09-21
2259,7383,-5124,1997,9,22,xyz,2026-09-22
3657,5887,-2230,1997,9,23,xyz,2026-09-23
1449,7249,-5800,1997,9,24,xyz,2026-09-24
3799,7568,-3769,1997,9,25,xyz,2026-09-25
8041,6675,1366,1997,9,26,xyz,2026-09-26
2830,5764,-2934,1997,9,27,xyz,2026-09-27
9829,3377,6452,1997,9,28,xyz,2026-09-28
8082,7106,976,1997,9,29,xyz,2026-09-29
8472,6434,2038,1997,9,30,xyz,2026-09-30
7481,6240,1241,1997,10,1,xyz,2026-10-01
6262,3594,2668,1997,10,2,xyz,2026-10-02
7033,3969,3064,1997,10,3,xyz,2026-10-03
6415,8350,-1935,1997,10,4,xyz,2026-10-04
8056,1229,6827,1997,10,5,xyz,2026-10-05
9874,7461,2413,1997,10,6,xyz,2026-10-06
9815,8667,1148,1997,10,7,xyz,2026-10-07
1330,9241,-7911,1997,10,8,xyz,2026-10-08
5310,7432,-2122,1997,10,9,xyz,2026-10-09
2398,7144,-4746,1997,10,10,xyz,2026-10-10
4736,1175,3561,1997,10,11,xyz,2026-10-11
2248,1904,344,1997,10,12,xyz,2026-10-12
6648,1128,5520,1997,10,13,xyz,2026-10-13
8620,1817,6803,1997,10,14,xyz,2026-10-14
2440,7053,-4613,1997,10,15,xyz,2026-10-15
7006,9537,-2531,1997,10,16,xyz,2026-10-16
8494,6872,1622,1997,10,17,xyz,2026-10-17
9726,5116,4610,1997,10,18,xyz,2026-10-18
8623,1803,6820,1997,10,19,xyz,2026-10-19
2668,3949,-1281,1997,10,20,xyz,2026-10-20
6402,8753,-2351,1997,10,21,xyz,2026-10-21
4503,1011,3492,1997,10,22,xyz,2026-10-22
7963,9149,-1186,1997,10,23,xyz,2026-10-23
2831,932,1899,1997,10,24,xyz,2026-10-24
5216,7657,-2441,1997,10,25,xyz,2026-10-25
6894,4546,2348,1997,10,26,xyz,2026-10-26
9923,1688,8235,1997,10,27,xyz,2026-10-27
9612,6825,2787,1997,10,28,xyz,2026-10-28
3687,7555,-3868,1997,10,29,xyz,2026-10-29
2977,2044,933,1997,10,30,xyz,2026-10-30
2654,2882,-228,1997,10,31,xyz,2026-10-31
6065,8046,-1981,1997,11,1,xyz,2026-11-01
3626,1655,1971,1997,11,2,xyz,2026-11-02
7143,4240,2903,1997,11,3,xyz,2026-11-03
6465,9068,-2603,1997,11,4,xyz,2026-11-04
3453,4985,-1532,1997,11,5,xyz,2026-11-05
2625,7928,-5303,1997,11,6,xyz,2026-11-06
5229,3210,2019,1997,11,7,xyz,2026-11-07
2496,2378,118,1997,11,8,xyz,2026-11-08
9290,5489,3801,1997,11,9,xyz,2026-11-09
9253,3544,5709,1997,11,10,xyz,2026-11-10
6695,3686,3009,1997,11,11,xyz,2026-11-11
2084,1480,604,1997,11,12,xyz,2026-11-12
7869,1603,6266,1997,11,13,xyz,2026-11-13
2763,2899,-136,1997,11,14,xyz,2026-11-14
7020,5885,1135,1997,11,15,xyz,2026-11-15
2934,8843,-5909,1997,11,16,xyz,2026-11-16
1112,4666,-3554,1997,11,17,xyz,2026-11-17
5452,5710,-258,1997,11,18,xyz,2026-11-18
6562,9278,-2716,1997,11,19,xyz,2026-11-19
5656,1803,3853,1997,11,20,xyz,2026-11-20
1318,591,727,1997,11,21,xyz,2026-11-21
9887,9387,500,1997,11,22,xyz,2026-11-22
8855,5311,3544,1997,11,23,xyz,2026-11-23
3380,7108,-3728,1997,11,24,xyz,2026-11-24
9916,2425,7491,1997,11,25,xyz,2026-11-25
7770,7541,229,1997,11,26,xyz,2026-11-26
6312,5650,662,1997,11,27,xyz,2026-11-27
1497,7616,-6119,1997,11,28,xyz,2026-11-28
5101,7827,-2726,1997,11,29,xyz,2026-11-29
6474,6687,-213,1997,11,30,xyz,2026-11-30
8902,501,8401,1997,12,1,xyz,2026-12-01
8788,4587,4201,1997,12,2,xyz,2026-12-02
2959,2570,389,1997,12,3,xyz,2026-12-03
8445,5279,3166,1997,12,4,xyz,2026-12-04
1730,7580,-5850,1997,12,5,xyz,2026-12-05
5668,4219,1449,1997,12,6,xyz,2026-12-06
1074,6479,-5405,1997,12,7,xyz,2026-12-07
6699,9717,-3018,1997,12,8,xyz,2026-12-08
2127,2387,-260,1997,12,9,xyz,2026-12-09
9387,5039,4348,1997,12,10,xyz,2026-12-10
3352,3611,-259,1997,12,11,xyz,2026-12-11
6215,6412,-197,1997,12,12,xyz,2026-12-12
4274,2363,1911,1997,12,13,xyz,2026-12-13
2412,8220,-5808,1997,12,14,xyz,2026-12-14
4334,3291,1043,1997,12,15,xyz,2026-12-15
2876,4785,-1909,1997,12,16,xyz,2026-12-16
5919,1898,4021,1997,12,17,xyz,2026-12-17
5001,3591,1410,1997,12,18,xyz,2026-12-18
9670,7878,1792,1997,12,19,xyz,2026-12-19
8925,5423,3502,1997,12,20,xyz,2026-12-20
2017,1061,956,1997,12,21,xyz,2026-12-21
4365,7899,-3534,1997,12,22,xyz,2026-12-22
3599,4559,-960,1997,12,23,xyz,2026-12-23
7751,1909,5842,1997,12,24,xyz,2026-12-24
2179,4720,-2541,1997,12,25,xyz,2026-12-25
1814,4893,-3079,1997,12,26,xyz,2026-12-26
2270,8105,-5835,1997,12,27,xyz,2026-12-27
4432,7434,-3002,1997,12,28,xyz,2026-12-28
3766,8739,-4973,1997,12,29,xyz,2026-12-29
1442,2453,-1011,1997,12,30,xyz,2026-12-30
9842,532,9310,1997,12,31,xyz,2026-12-31
8198,5051,3147,1998,1,1,xyz,2027-01-01
7115,1192,5923,1998,1,2,xyz,2027-01-02
6916,2686,4230,1998,1,3,xyz,2027-01-03
5610,9502,-3892,1998,1,4,xyz,2027-01-04
9188,3207,5981,1998,1,5,xyz,2027-01-05
9501,2153,7348,1998,1,6,xyz,2027-01-06
1474,1708,-234,1998,1,7,xyz,2027-01-07
5869,1052,4817,1998,1,8,xyz,2027-01-08
5629,6200,-571,1998,1,9,xyz,2027-01-09
3541,7164,-3623,1998,1,10,xyz,2027-01-10
8949,9817,-868,1998,1,11,xyz,2027-01-11
2010,4464,-2454,1998,1,12,xyz,2027-01-12
2614,2336,278,1998,1,13,xyz,2027-01-13
9665,4510,5155,1998,1,14,xyz,2027-01-14
7008,577,6431,1998,1,15,xyz,2027-01-15
4705,7008,-2303,1998,1,16,xyz,2027-01-16
5230,3570,1660,1998,1,17,xyz,2027-01-17
6114,7749,-1635,1998,1,18,xyz,2027-01-18
2619,5487,-2868,1998,1,19,xyz,2027-01-19
3417,3124,293,1998,1,20,xyz,2027-01-20
7815,6228,1587,1998,1,21,xyz,2027-01-21
6603,4475,2128,1998,1,22,xyz,2027-01-22
8981,730,8251,1998,1,23,xyz,2027-01-23
9133,3175,5958,1998,1,24,xyz,2027-01-24
9616,4628,4988,1998,1,25,xyz,2027-01-25
6328,3300,3028,1998,1,26,xyz,2027-01-26
7456,6158,1298,1998,1,27,xyz,2027-01-27
8987,973,8014,1998,1,28,xyz,2027-01-28
6479,9519,-3040,1998,1,29,xyz,2027-01-29
6001,8938,-2937,1998,1,30,xyz,2027-01-30
2260,3410,-1150,1998,1,31,xyz,2027-01-31
3807,5420,-1613,1998,2,1,xyz,2027-02-01
5967,4160,1807,1998,2,2,xyz,2027-02-02
2119,3924,-1805,1998,2,3,xyz,2027-02-03
3951,6685,-2734,1998,2,4,xyz,2027-02-04
6421,7131,-710,1998,2,5,xyz,2027-02-05
9694,1243,8451,1998,2,6,xyz,2027-02-06
8611,972,7639,1998,2,7,xyz,2027-02-07
6044,2248,3796,1998,2,8,xyz,2027-02-08
9924,8305,1619,1998,2,9,xyz,2027-02-09
2553,7292,-4739,1998,2,10,xyz,2027-02-10
5093,2429,2664,1998,2,11,xyz,2027-02-11
8892,1758,7134,1998,2,12,xyz,2027-02-12
9118,5954,3164,1998,2,13,xyz,2027-02-13
1519,2157,-638,1998,2,14,xyz,2027-02-14
3766,1199,2567,1998,2,15,xyz,2027-02-15
3580,9995,-6415,1998,2,16,xyz,2027-02-16
8773,7596,1177,1998,2,17,xyz,2027-02-17
8860,2849,6011,1998,2,18,xyz,2027-02-18
9728,5673,4055,1998,2,19,xyz,2027-02-19
2735,8433,-5698,1998,2,20,xyz,2027-02-20
6231,3334,2897,1998,2,21,xyz,2027-02-21
5451,4074,1377,1998,2,22,xyz,2027-02-22
3360,685,2675,1998,2,23,xyz,2027-02-23
6534,913,5621,1998,2,24,xyz,2027-02-24
4328,3658,670,1998,2,25,xyz,2027-02-25
5675,4391,1284,1998,2,26,xyz,2027-02-26
2083,866,1217,1998,2,27,xyz,2027-02-27
7571,1433,6138,1998,2,28,xyz,2027-02-28
2245,3924,-1679,1998,3,1,xyz,2027-03-01
4868,6616,-1748,1998,3,2,xyz,2027-03-02
4961,9917,-4956,1998,3,3,xyz,2027-03-03
9277,7907,1370,1998,3,4,xyz,2027-03-04
9027,9244,-217,1998,3,5,xyz,2027-03-05
8347,3290,5057,1998,3,6,xyz,2027-03-06
1701,8703,-7002,1998,3,7,xyz,2027-03-07
8375,9673,-1298,1998,3,8,xyz,2027-03-08
4376,9458,-5082,1998,3,9,xyz,2027-03-09
1107,840,267,1998,3,10,xyz,2027-03-10
9521,1230,8291,1998,3,11,xyz,2027-03-11
2751,4784,-2033,1998,3,12,xyz,2027-03-12
5912,7175,-1263,1998,3,13,xyz,2027-03-13
6448,7481,-1033,1998,3,14,xyz,2027-03-14
7901,920,6981,1998,3,15,xyz,2027-03-15
10000,7474,2526,1998,3,16,xyz,2027-03-16
3177,1313,1864,1998,3,17,xyz,2027-03-17
6107,2458,3649,1998,3,18,xyz,2027-03-18
7947,5614,2333,1998,3,19,xyz,2027-03-19
2124,7502,-5378,1998,3,20,xyz,2027-03-20
7966,6786,1180,1998,3,21,xyz,2027-03-21
2220,956,1264,1998,3,22,xyz,2027-03-22
1006,4698,-3692,1998,3,23,xyz,2027-03-23
9819,5405,4414,1998,3,24,xyz,2027-03-24
4560,3992,568,1998,3,25,xyz,2027-03-25
1069,2619,-1550,1998,3,26,xyz,2027-03-26
3572,2934,638,1998,3,27,xyz,2027-03-27
4890,8359,-3469,1998,3,28,xyz,2027-03-28
2218,3929,-1711,1998,3,29,xyz,2027-03-29
5155,2573,2582,1998,3,30,xyz,2027-03-30
7150,659,6491,1998,3,31,xyz,2027-03-31
9858,1407,8451,1998,4,1,xyz,2027-04-01
9975,5215,4760,1998,4,2,xyz,2027-04-02
9532,7639,1893,1998,4,3,xyz,2027-04-03
9621,5512,4109,1998,4,4,xyz,2027-04-04
7408,9464,-2056,1998,4,5,xyz,2027-04-05
5742,4687,1055,1998,4,6,xyz,2027-04-06
3644,6420,-2776,1998,4,7,xyz,2027-04-07
2132,4551,-2419,1998,4,8,xyz,2027-04-08
6245,7303,-1058,1998,4,9,xyz,2027-04-09
7768,5922,1846,1998,4,10,xyz,2027-04-10
3225,1739,1486,1998,4,11,xyz,2027-04-11
2878,7025,-4147,1998,4,12,xyz,2027-04-12
9071,9395,-324,1998,4,13,xyz,2027-04-13
2858,4488,-1630,1998,4,14,xyz,2027-04-14
9976,8671,1305,1998,4,15,xyz,2027-04-15
7127,1055,6072,1998,4,16,xyz,2027-04-16
5961,5832,129,1998,4,17,xyz,2027-04-17
5527,3248,2279,1998,4,18,xyz,2027-04-18
8220,7192,1028,1998,4,19,xyz,2027-04-19
9185,9108,77,1998,4,20,xyz,2027-04-20
9508,4542,4966,1998,4,21,xyz,2027-04-21
5975,7882,-1907,1998,4,22,xyz,2027-04-22
1284,8693,-7409,1998,4,23,xyz,2027-04-23
5043,2617,2426,1998,4,24,xyz,2027-04-24
2476,5509,-3033,1998,4,25,xyz,2027-04-25
3357,6854,-3497,1998,4,26,xyz,2027-04-26
4131,8928,-4797,1998,4,27,xyz,2027-04-27
2481,2616,-135,1998,4,28,xyz,2027-04-28
1835,5373,-3538,1998,4,29,xyz,2027-04-29
9301,3143,6158,1998,4,30,xyz,2027-04-30
5543,8556,-3013,1998,5,1,xyz,2027-05-01
2565,1695,870,1998,5,2,xyz,2027-05-02
2745,3723,-978,1998,5,3,xyz,2027-05-03
3269,1924,1345,1998,5,4,xyz,2027-05-04
7025,8980,-1955,1998,5,5,xyz,2027-05-05
5885,4924,961,1998,5,6,xyz,2027-05-06
6860,9956,-3096,1998,5,7,xyz,2027-05-07
8101,5984,2117,1998,5,8,xyz,2027-05-08
1647,5970,-4323,1998,5,9,xyz,2027-05-09
4458,7575,-3117,1998,5,10,xyz,2027-05-10
2429,5164,-2735,1998,5,11,xyz,2027-05-11
5179,7563,-2384,1998,5,12,xyz,2027-05-12
5785,9021,-3236,1998,5,13,xyz,2027-05-13
5249,8004,-2755,1998,5,14,xyz,2027-05-14
4860,9887,-5027,1998,5,15,xyz,2027-05-15
6414,4148,2266,1998,5,16,xyz,2027-05-16
2540,2391,149,1998,5,17,xyz,2027-05-17
6533,7539,-1006,1998,5,18,xyz,2027-05-18
7772,9237,-1465,1998,5,19,xyz,2027-05-19
7058,4703,2355,1998,5,20,xyz,2027-05-20
4897,4990,-93,1998,5,21,xyz,2027-05-21
7343,2780,4563,1998,5,22,xyz,2027-05-22
2985,9670,-6685,1998,5,23,xyz,2027-05-23
2592,5412,-2820,1998,5,24,xyz,2027-05-24
7274,5436,1838,1998,5,25,xyz,2027-05-25
5209,4779,430,1998,5,26,xyz,2027-05-26
6230,6549,-319,1998,5,27,xyz,2027-05-27
3298,579,2719,1998,5,28,xyz,2027-05-28
2500,1744,756,1998,5,29,xyz,2027-05-29
9269,3546,5723,1998,5,30,xyz,2027-05-30
4995,9148,-4153,1998,5,31,xyz,2027-05-31
7151,2779,4372,1998,6,1,xyz,2027-06-01
8664,7153,1511,1998,6,2,xyz,2027-06-02
5643,9977,-4334,1998,6,3,xyz,2027-06-03
7043,5847,1196,1998,6,4,xyz,2027-06-04
5208,7236,-2028,1998,6,5,xyz,2027-06-05
7474,875,6599,1998,6,6,xyz,2027-06-06
4671,5363,-692,1998,6,7,xyz,2027-06-07
7655,5322,2333,1998,6,8,xyz,2027-06-08
1005,9237,-8232,1998,6,9,xyz,2027-06-09
1409,6430,-5021,1998,6,10,xyz,2027-06-10
8763,7752,1011,1998,6,11,xyz,2027-06-11
7121,1822,5299,1998,6,12,xyz,2027-06-12
8160,5333,2827,1998,6,13,xyz,2027-06-13
4211,586,3625,1998,6,14,xyz,2027-06-14
2874,5456,-2582,1998,6,15,xyz,2027-06-15
3510,6456,-2946,1998,6,16,xyz,2027-06-16
5615,6902,-1287,1998,6,17,xyz,2027-06-17
5024,3929,1095,1998,6,18,xyz,2027-06-18
6027,4777,1250,1998,6,19,xyz,2027-06-19
3390,2119,1271,1998,6,20,xyz,2027-06-20
1892,5059,-3167,1998,6,21,xyz,2027-06-21
6641,6665,-24,1998,6,22,xyz,2027-06-22
7503,9421,-1918,1998,6,23,xyz,2027-06-23
9354,3626,5728,1998,6,24,xyz,2027-06-24
8354,582,7772,1998,6,25,xyz,2027-06-25
6913,4732,2181,1998,6,26,xyz,2027-06-26
8077,1499,6578,1998,6,27,xyz,2027-06-27
7860,8813,-953,1998,6,28,xyz,2027-06-28
4746,7593,-2847,1998,6,29,xyz,2027-06-29
7996,2532,5464,1998,6,30,xyz,2027-06-30
6649,4557,2092,1998,7,1,xyz,2027-07-01
3000,8261,-5261,1998,7,2,xyz,2027-07-02
2553,7325,-4772,1998,7,3,xyz,2027-07-03
2282,8707,-6425,1998,7,4,xyz,2027-07-04
5778,4149,1629,1998,7,5,xyz,2027-07-05
4136,6382,-2246,1998,7,6,xyz,2027-07-06
1655,9727,-8072,1998,7,7,xyz,2027-07-07
2081,2684,-603,1998,7,8,xyz,2027-07-08
6038,1393,4645,1998,7,9,xyz,2027-07-09
7716,4222,3494,1998,7,10,xyz,2027-07-10
2581,554,2027,1998,7,11,xyz,2027-07-11
4937,4343,594,1998,7,12,xyz,2027-07-12
7226,3507,3719,1998,7,13,xyz,2027-07-13
8056,5388,2668,1998,7,14,xyz,2027-07-14
3826,2122,1704,1998,7,15,xyz,2027-07-15
9346,751,8595,1998,7,16,xyz,2027-07-16
7051,5977,1074,1998,7,17,xyz,2027-07-17
3686,9994,-6308,1998,7,18,xyz,2027-07-18
3232,1982,1250,1998,7,19,xyz,2027-07-19
3485,8294,-4809,1998,7,20,xyz,2027-07-20
8619,1161,7458,1998,7,21,xyz,2027-07-21
6057,2892,3165,1998,7,22,xyz,2027-07-22
5136,5069,67,1998,7,23,xyz,2027-07-23
2078,6700,-4622,1998,7,24,xyz,2027-07-24
5222,8589,-3367,1998,7,25,xyz,2027-07-25
4004,5404,-1400,1998,7,26,xyz,2027-07-26
2526,3195,-669,1998,7,27,xyz,2027-07-27
2102,3628,-1526,1998,7,28,xyz,2027-07-28
7833,4066,3767,1998,7,29,xyz,2027-07-29
5808,8788,-2980,1998,7,30,xyz,2027-07-30
7207,1135,6072,1998,7,31,xyz,2027-07-31
2415,1254,1161,1998,8,1,xyz,2027-08-01
2231,1027,1204,1998,8,2,xyz,2027-08-02
5183,7043,-1860,1998,8,3,xyz,2027-08-03
6293,3247,3046,1998,8,4,xyz,2027-08-04
8932,7750,1182,1998,8,5,xyz,2027-08-05
1344,7682,-6338,1998,8,6,xyz,2027-08-06
3184,6098,-2914,1998,8,7,xyz,2027-08-07
1378,6248,-4870,1998,8,8,xyz,2027-08-08
4309,5331,-1022,1998,8,9,xyz,2027-08-09
6792,6821,-29,1998,8,10,xyz,2027-08-10
4503,5900,-1397,1998,8,11,xyz,2027-08-11
9527,3515,6012,1998,8,12,xyz,2027-08-12
4699,9947,-5248,1998,8,13,xyz,2027-08-13
1216,1139,77,1998,8,14,xyz,2027-08-14
8398,7294,1104,1998,8,15,xyz,2027-08-15
2048,2314,-266,1998,8,16,xyz,2027-08-16
4151,8748,-4597,1998,8,17,xyz,2027-08-17
9628,7602,2026,1998,8,18,xyz,2027-08-18
2036,1531,505,1998,8,19,xyz,2027-08-19
6379,2158,4221,1998,8,20,xyz,2027-08-20
5761,1350,4411,1998,8,21,xyz,2027-08-21
4370,2065,2305,1998,8,22,xyz,2027-08-22
7586,3590,3996,1998,8,23,xyz,2027-08-23
8361,5556,2805,1998,8,24,xyz,2027-08-24
1019,7431,-6412,1998,8,25,xyz,2027-08-25
1931,5716,-3785,1998,8,26,xyz,2027-08-26
9653,6166,3487,1998,8,27,xyz,2027-08-27
8253,3234,5019,1998,8,28,xyz,2027-08-28
6979,2177,4802,1998,8,29,xyz,2027-08-29
4490,4236,254,1998,8,30,xyz,2027-08-30
2035,6708,-4673,1998,8,31,xyz,2027-08-31
6212,9165,-2953,1998,9,1,xyz,2027-09-01
3249,5734,-2485,1998,9,2,xyz,2027-09-02
3265,7218,-3953,1998,9,3,xyz,2027-09-03
4224,5696,-1472,1998,9,4,xyz,2027-09-04
5814,6702,-888,1998,9,5,xyz,2027-09-05
4454,6497,-2043,1998,9,6,xyz,2027-09-06
3143,3426,-283,1998,9,7,xyz,2027-09-07
2466,1226,1240,1998,9,8,xyz,2027-09-08
1325,5349,-4024,1998,9,9,xyz,2027-09-09
3139,5441,-2302,1998,9,10,xyz,2027-09-10
7523,4546,2977,1998,9,11,xyz,2027-09-11
1657,1144,513,1998,9,12,xyz,2027-09-12
6783,1575,5208,1998,9,13,xyz,2027-09-13
6051,759,5292,1998,9,14,xyz,2027-09-14
7885,2052,5833,1998,9,15,xyz,2027-09-15
5363,2911,2452,1998,9,16,xyz,2027-09-16
3555,1102,2453,1998,9,17,xyz,2027-09-17
5028,9962,-4934,1998,9,18,xyz,2027-09-18
1153,5497,-4344,1998,9,19,xyz,2027-09-19
1119,2343,-1224,1998,9,20,xyz,2027-09-20
7876,7664,212,1998,9,21,xyz,2027-09-21
2723,3138,-415,1998,9,22,xyz,2027-09-22
6877,7730,-853,1998,9,23,xyz,2027-09-23
1952,3592,-1640,1998,9,24,xyz,2027-09-24
2895,5446,-2551,1998,9,25,xyz,2027-09-25
1350,8496,-7146,1998,9,26,xyz,2027-09-26
9624,1140,8484,1998,9,27,xyz,2027-09-27
8988,1186,7802,1998,9,28,xyz,2027-09-28
8830,1962,6868,1998,9,29,xyz,2027-09-29
6106,5497,609,1998,9,30,xyz,2027-09-30
4872,3893,979,1998,10,1,xyz,2027-10-01
2942,8155,-5213,1998,10,2,xyz,2027-10-02
8306,8699,-393,1998,10,3,xyz,2027-10-03
9455,4101,5354,1998,10,4,xyz,2027-10-04
7354,8486,-1132,1998,10,5,xyz,2027-10-05
4089,7771,-3682,1998,10,6,xyz,2027-10-06
8896,1235,7661,1998,10,7,xyz,2027-10-07
2586,4836,-2250,1998,10,8,xyz,2027-10-08
5111,7578,-2467,1998,10,9,xyz,2027-10-09
2017,9776,-7759,1998,10,10,xyz,2027-10-10
7975,4273,3702,1998,10,11,xyz,2027-10-11
7629,3336,4293,1998,10,12,xyz,2027-10-12
9988,6196,3792,1998,10,13,xyz,2027-10-13
5602,9590,-3988,1998,10,14,xyz,2027-10-14
2651,9094,-6443,1998,10,15,xyz,2027-10-15
2219,6227,-4008,1998,10,16,xyz,2027-10-16
7518,6453,1065,1998,10,17,xyz,2027-10-17
7436,3911,3525,1998,10,18,xyz,2027-10-18
8943,7707,1236,1998,10,19,xyz,2027-10-19
3756,5486,-1730,1998,10,20,xyz,2027-10-20
4258,6598,-2340,1998,10,21,xyz,2027-10-21
8175,9521,-1346,1998,10,22,xyz,2027-10-22
9828,2268,7560,1998,10,23,xyz,2027-10-23
2718,4456,-1738,1998,10,24,xyz,2027-10-24
3614,6279,-2665,1998,10,25,xyz,2027-10-25
8471,885,7586,1998,10,26,xyz,2027-10-26
7999,9197,-1198,1998,10,27,xyz,2027-10-27
2647,3493,-846,1998,10,28,xyz,2027-10-28
7936,5750,2186,1998,10,29,xyz,2027-10-29
9241,5238,4003,1998,10,30,xyz,2027-10-30
7076,9505,-2429,1998,10,31,xyz,2027-10-31
6190,7542,-1352,1998,11,1,xyz,2027-11-01
3622,609,3013,1998,11,2,xyz,2027-11-02
6452,7841,-1389,1998,11,3,xyz,2027-11-03
8060,8138,-78,1998,11,4,xyz,2027-11-04
5162,5197,-35,1998,11,5,xyz,2027-11-05
5621,787,4834,1998,11,6,xyz,2027-11-06
9111,5204,3907,1998,11,7,xyz,2027-11-07
4323,5800,-1477,1998,11,8,xyz,2027-11-08
8237,3619,4618,1998,11,9,xyz,2027-11-09
4440,4599,-159,1998,11,10,xyz,2027-11-10
2221,5328,-3107,1998,11,11,xyz,2027-11-11
3869,6897,-3028,1998,11,12,xyz,2027-11-12
1210,6858,-5648,1998,11,13,xyz,2027-11-13
8412,1160,7252,1998,11,14,xyz,2027-11-14
8389,7436,953,1998,11,15,xyz,2027-11-15
9191,1865,7326,1998,11,16,xyz,2027-11-16
4538,8146,-3608,1998,11,17,xyz,2027-11-17
8024,4283,3741,1998,11,18,xyz,2027-11-18
2864,5195,-2331,1998,11,19,xyz,2027-11-19
2267,8000,-5733,1998,11,20,xyz,2027-11-20
1564,4448,-2884,1998,11,21,xyz,2027-11-21
3069,2187,882,1998,11,22,xyz,2027-11-22
5473,9022,-3549,1998,11,23,xyz,2027-11-23
7716,848,6868,1998,11,24,xyz,2027-11-24
8768,3425,5343,1998,11,25,xyz,2027-11-25
1636,4332,-2696,1998,11,26,xyz,2027-11-26
5505,3354,2151,1998,11,27,xyz,2027-11-27
8559,5659,2900,1998,11,28,xyz,2027-11-28
5879,2894,2985,1998,11,29,xyz,2027-11-29
3286,2621,665,1998,11,30,xyz,2027-11-30
9622,8021,1601,1998,12,1,xyz,2027-12-01
6835,8701,-1866,1998,12,2,xyz,2027-12-02
6885,5105,1780,1998,12,3,xyz,2027-12-03
9793,595,9198,1998,12,4,xyz,2027-12-04
4379,4246,133,1998,12,5,xyz,2027-12-05
3276,3554,-278,1998,12,6,xyz,2027-12-06
6301,8141,-1840,1998,12,7,xyz,2027-12-07
2652,7092,-4440,1998,12,8,xyz,2027-12-08
2012,1321,691,1998,12,9,xyz,2027-12-09
1644,5093,-3449,1998,12,10,xyz,2027-12-10
9664,5810,3854,1998,12,11,xyz,2027-12-11
1502,3556,-2054,1998,12,12,xyz,2027-12-12
6604,9112,-2508,1998,12,13,xyz,2027-12-13
2241,8044,-5803,1998,12,14,xyz,2027-12-14
2303,4440,-2137,1998,12,15,xyz,2027-12-15
8212,1959,6253,1998,12,16,xyz,2027-12-16
8532,3967,4565,1998,12,17,xyz,2027-12-17
5729,5473,256,1998,12,18,xyz,2027-12-18
1328,5457,-4129,1998,12,19,xyz,2027-12-19
6328,1736,4592,1998,12,20,xyz,2027-12-20
5160,9983,-4823,1998,12,21,xyz,2027-12-21
6615,6858,-243,1998,12,22,xyz,2027-12-22
8093,3871,4222,1998,12,23,xyz,2027-12-23
9573,7689,1884,1998,12,24,xyz,2027-12-24
6283,9404,-3121,1998,12,25,xyz,2027-12-25
1530,3889,-2359,1998,12,26,xyz,2027-12-26
5453,9242,-3789,1998,12,27,xyz,2027-12-27
8163,6963,1200,1998,12,28,xyz,2027-12-28
9478,3279,6199,1998,12,29,xyz,2027-12-29
7689,7163,526,1998,12,30,xyz,2027-12-30
1699,5926,-4227,1998,12,31,xyz,2027-12-31
4137,7236,-3099,1999,1,1,xyz,2028-01-01
9146,3713,5433,1999,1,2,xyz,2028-01-02
1954,8296,-6342,1999,1,3,xyz,2028-01-03
7725,6698,1027,1999,1,4,xyz,2028-01-04
4734,9604,-4870,1999,1,5,xyz,2028-01-05
2052,8773,-6721,1999,1,6,xyz,2028-01-06
8213,8633,-420,1999,1,7,xyz,2028-01-07
3558,874,2684,1999,1,8,xyz,2028-01-08
8138,5376,2762,1999,1,9,xyz,2028-01-09
1036,719,317,1999,1,10,xyz,2028-01-10
3802,961,2841,1999,1,11,xyz,2028-01-11
2142,7871,-5729,1999,1,12,xyz,2028-01-12
8460,7769,691,1999,1,13,xyz,2028-01-13
5921,1164,4757,1999,1,14,xyz,2028-01-14
5880,9790,-3910,1999,1,15,xyz,2028-01-15
6569,9031,-2462,1999,1,16,xyz,2028-01-16
6638,2108,4530,1999,1,17,xyz,2028-01-17
2601,4624,-2023,1999,1,18,xyz,2028-01-18
5517,9281,-3764,1999,1,19,xyz,2028-01-19
6614,6034,580,1999,1,20,xyz,2028-01-20
8988,5477,3511,1999,1,21,xyz,2028-01-21
8083,7119,964,1999,1,22,xyz,2028-01-22
8573,1074,7499,1999,1,23,xyz,2028-01-23
4249,878,3371,1999,1,24,xyz,2028-01-24
9986,3287,6699,1999,1,25,xyz,2028-01-25
2310,4913,-2603,1999,1,26,xyz,2028-01-26
7491,1774,5717,1999,1,27,xyz,2028-01-27
5129,7938,-2809,1999,1,28,xyz,2028-01-28
3543,5633,-2090,1999,1,29,xyz,2028-01-29
6107,8918,-2811,1999,1,30,xyz,2028-01-30
3175,9524,-6349,1999,1,31,xyz,2028-01-31
7989,4773,3216,1999,2,1,xyz,2028-02-01
1789,3865,-2076,1999,2,2,xyz,2028-02-02
8571,4079,4492,1999,2,3,xyz,2028-02-03
4689,9228,-4539,1999,2,4,xyz,2028-02-04
3345,7079,-3734,1999,2,5,xyz,2028-02-05
1833,6042,-4209,1999,2,6,xyz,2028-02-06
6073,3108,2965,1999,2,7,xyz,2028-02-07
9241,7632,1609,1999,2,8,xyz,2028-02-08
2695,4807,-2112,1999,2,9,xyz,2028-02-09
8357,2196,6161,1999,2,10,xyz,2028-02-10
6818,2371,4447,1999,2,11,xyz,2028-02-11
4256,6599,-2343,1999,2,12,xyz,2028-02-12
9305,1000,8305,1999,2,13,xyz,2028-02-13
7497,5205,2292,1999,2,14,xyz,2028-02-14
5187,8685,-3498,1999,2,15,xyz,2028-02-15
6896,1591,5305,1999,2,16,xyz,2028-02-16
5957,7223,-1266,1999,2,17,xyz,2028-02-17
8400,5121,3279,1999,2,18,xyz,2028-02-18
9094,8647,447,1999,2,19,xyz,2028-02-19
7800,2602,5198,1999,2,20,xyz,2028-02-20
6349,568,5781,1999,2,21,xyz,2028-02-21
3686,8295,-4609,1999,2,22,xyz,2028-02-22
5190,2785,2405,1999,2,23,xyz,2028-02-23
4796,981,3815,1999,2,24,xyz,2028-02-24
2056,9971,-7915,1999,2,25,xyz,2028-02-25
2518,5242,-2724,1999,2,26,xyz,2028-02-26
4514,4531,-17,1999,2,27,xyz,2028-02-27
3760,2141,1619,1999,2,28,xyz,2028-02-28
7019,3223,3796,1999,2,29,xyz,2028-02-29
9107,9332,-225,1999,3,1,xyz,2028-03-01
6107,6820,-713,1999,3,2,xyz,2028-03-02
8984,2913,6071,1999,3,3,xyz,2028-03-03
7973,4692,3281,1999,3,4,xyz,2028-03-04
6379,5457,922,1999,3,5,xyz,2028-03-05
8842,8241,601,1999,3,6,xyz,2028-03-06
4783,6430,-1647,1999,3,7,xyz,2028-03-07
8982,1501,7481,1999,3,8,xyz,2028-03-08
3478,9550,-6072,1999,3,9,xyz,2028-03-09
4077,7065,-2988,1999,3,10,xyz,2028-03-10
8243,8157,86,1999,3,11,xyz,2028-03-11
9046,7444,1602,1999,3,12,xyz,2028-03-12
4265,2128,2137,1999,3,13,xyz,2028-03-13
4045,8991,-4946,1999,3,14,xyz,2028-03-14
4938,7109,-2171,1999,3,15,xyz,2028-03-15
9061,7214,1847,1999,3,16,xyz,2028-03-16
1195,5935,-4740,1999,3,17,xyz,2028-03-17
1555,5344,-3789,1999,3,18,xyz,2028-03-18
4992,3223,1769,1999,3,19,xyz,2028-03-19
5180,8301,-3121,1999,3,20,xyz,2028-03-20
2711,9482,-6771,1999,3,21,xyz,2028-03-21
3361,8703,-5342,1999,3,22,xyz,2028-03-22
7112,3023,4089,1999,3,23,xyz,2028-03-23
4582,8026,-3444,1999,3,24,xyz,2028-03-24
6870,8033,-1163,1999,3,25,xyz,2028-03-25
2152,9987,-7835,1999,3,26,xyz,2028-03-26
9603,5211,4392,1999,3,27,xyz,2028-03-27
5534,3841,1693,1999,3,28,xyz,2028-03-28
5588,8355,-2767,1999,3,29,xyz,2028-03-29
1687,6408,-4721,1999,3,30,xyz,2028-03-30
7276,6903,373,1999,3,31,xyz,2028-03-31
9636,6515,3121,1999,4,1,xyz,2028-04-01
9225,7655,1570,1999,4,2,xyz,2028-04-02
5152,7921,-2769,1999,4,3,xyz,2028-04-03
8309,4622,3687,1999,4,4,xyz,2028-04-04
8128,2359,5769,1999,4,5,xyz,2028-04-05
7530,3692,3838,1999,4,6,xyz,2028-04-06
8174,4849,3325,1999,4,7,xyz,2028-04-07
5176,6814,-1638,1999,4,8,xyz,2028-04-08
9198,4669,4529,1999,4,9,xyz,2028-04-09
2360,3196,-836,1999,4,10,xyz,2028-04-10
7503,5622,1881,1999,4,11,xyz,2028-04-11
1302,1090,212,1999,4,12,xyz,2028-04-12
3054,6227,-3173,1999,4,13,xyz,2028-04-13
1853,5043,-3190,1999,4,14,xyz,2028-04-14
9107,8065,1042,1999,4,15,xyz,2028-04-15
3298,7014,-3716,1999,4,16,xyz,2028-04-16
3187,5224,-2037,1999,4,17,xyz,2028-04-17
2353,5905,-3552,1999,4,18,xyz,2028-04-18
2831,4040,-1209,1999,4,19,xyz,2028-04-19
5895,3689,2206,1999,4,20,xyz,2028-04-20
7104,5808,1296,1999,4,21,xyz,2028-04-21
3566,1197,2369,1999,4,22,xyz,2028-04-22
4495,4799,-304,1999,4,23,xyz,2028-04-23
1222,9072,-7850,1999,4,24,xyz,2028-04-24
1873,9745,-7872,1999,4,25,xyz,2028-04-25
9695,1588,8107,1999,4,26,xyz,2028-04-26
4237,3073,1164,1999,4,27,xyz,2028-04-27
1319,3505,-2186,1999,4,28,xyz,2028-04-28
9571,2464,7107,1999,4,29,xyz,2028-04-29
1967,1537,430,1999,4,30,xyz,2028-04-30
5937,3996,1941,1999,5,1,xyz,2028-05-01
7764,6820,944,1999,5,2,xyz,2028-05-02
6518,6363,155,1999,5,3,xyz,2028-05-03
3586,5777,-2191,1999,5,4,xyz,2028-05-04
1467,4502,-3035,1999,5,5,xyz,2028-05-05
3093,5934,-2841,1999,5,6,xyz,2028-05-06
6776,6196,580,1999,5,7,xyz,2028-05-07
3461,8103,-4642,1999,5,8,xyz,2028-05-08
1260,7119,-5859,1999,5,9,xyz,2028-05-09
9370,9586,-216,1999,5,10,xyz,2028-05-10
9339,6867,2472,1999,5,11,xyz,2028-05-11
6705,3241,3464,1999,5,12,xyz,2028-05-12
1168,3503,-2335,1999,5,13,xyz,2028-05-13
8435,4435,4000,1999,5,14,xyz,2028-05-14
5261,931,4330,1999,5,15,xyz,2028-05-15
9063,8038,1025,1999,5,16,xyz,2028-05-16
4429,9539,-5110,1999,5,17,xyz,2028-05-17
2170,8797,-6627,1999,5,18,xyz,2028-05-18
2736,3952,-1216,1999,5,19,xyz,2028-05-19
2704,4340,-1636,1999,5,20,xyz,2028-05-20
5983,2237,3746,1999,5,21,xyz,2028-05-21
2018,2892,-874,1999,5,22,xyz,2028-05-22
3530,2192,1338,1999,5,23,xyz,2028-05-23
3607,7914,-4307,1999,5,24,xyz,2028-05-24
3477,2354,1123,1999,5,25,xyz,2028-05-25
9199,7017,2182,1999,5,26,xyz,2028-05-26
4567,3410,1157,1999,5,27,xyz,2028-05-27
9338,937,8401,1999,5,28,xyz,2028-05-28
4198,3176,1022,1999,5,29,xyz,2028-05-29
1158,7107,-5949,1999,5,30,xyz,2028-05-30
7140,1974,5166,1999,5,31,xyz,2028-05-31
8616,2015,6601,1999,6,1,xyz,2028-06-01
9630,3050,6580,1999,6,2,xyz,2028-06-02
4312,2800,1512,1999,6,3,xyz,2028-06-03
3602,1196,2406,1999,6,4,xyz,2028-06-04
2137,5507,-3370,1999,6,5,xyz,2028-06-05
4176,9589,-5413,1999,6,6,xyz,2028-06-06
6659,4299,2360,1999,6,7,xyz,2028-06-07
5810,8096,-2286,1999,6,8,xyz,2028-06-08
8014,9942,-1928,1999,6,9,xyz,2028-06-09
3721,9405,-5684,1999,6,10,xyz,2028-06-10
6492,5383,1109,1999,6,11,xyz,2028-06-11
2339,4346,-2007,1999,6,12,xyz,2028-06-12
8971,2456,6515,1999,6,13,xyz,2028-06-13
2249,845,1404,1999,6,14,xyz,2028-06-14
9879,8490,1389,1999,6,15,xyz,2028-06-15
7109,7970,-861,1999,6,16,xyz,2028-06-16
9796,8153,1643,1999,6,17,xyz,2028-06-17
8465,5738,2727,1999,6,18,xyz,2028-06-18
1770,1431,339,1999,6,19,xyz,2028-06-19
7104,3529,3575,1999,6,20,xyz,2028-06-20
6792,4134,2658,1999,6,21,xyz,2028-06-21
6840,7145,-305,1999,6,22,xyz,2028-06-22
3430,6487,-3057,1999,6,23,xyz,2028-06-23
4332,2312,2020,1999,6,24,xyz,2028-06-24
8519,566,7953,1999,6,25,xyz,2028-06-25
3392,7910,-4518,1999,6,26,xyz,2028-06-26
1589,562,1027,1999,6,27,xyz,2028-06-27
2102,3281,-1179,1999,6,28,xyz,2028-06-28
7715,8236,-521,1999,6,29,xyz,2028-06-29
3725,7486,-3761,1999,6,30,xyz,2028-06-30
3173,5826,-2653,1999,7,1,xyz,2028-07-01
1322,1672,-350,1999,7,2,xyz,2028-07-02
7684,4412,3272,1999,7,3,xyz,2028-07-03
3517,3667,-150,1999,7,4,xyz,2028-07-04
2400,1093,1307,1999,7,5,xyz,2028-07-05
3410,5067,-1657,1999,7,6,xyz,2028-07-06
7604,3577,4027,1999,7,7,xyz,2028-07-07
9767,3510,6257,1999,7,8,xyz,2028-07-08
7868,4124,3744,1999,7,9,xyz,2028-07-09
4984,4287,697,1999,7,10,xyz,2028-07-10
6384,4973,1411,1999,7,11,xyz,2028-07-11
1056,8659,-7603,1999,7,12,xyz,2028-07-12
3296,5230,-1934,1999,7,13,xyz,2028-07-13
9969,4728,5241,1999,7,14,xyz,2028-07-14
6734,3213,3521,1999,7,15,xyz,2028-07-15
7850,6277,1573,1999,7,16,xyz,2028-07-16
8354,1482,6872,1999,7,17,xyz,2028-07-17
2149,3799,-1650,1999,7,18,xyz,2028-07-18
6189,3948,2241,1999,7,19,xyz,2028-07-19
1757,3409,-1652,1999,7,20,xyz,2028-07-20
2113,6206,-4093,1999,7,21,xyz,2028-07-21
7120,8833,-1713,1999,7,22,xyz,2028-07-22
4809,6183,-1374,1999,7,23,xyz,2028-07-23
3304,7198,-3894,1999,7,24,xyz,2028-07-24
7911,4371,3540,1999,7,25,xyz,2028-07-25
5609,7825,-2216,1999,7,26,xyz,2028-07-26
4506,4575,-69,1999,7,27,xyz,2028-07-27
1813,5296,-3483,1999,7,28,xyz,2028-07-28
5243,4240,1003,1999,7,29,xyz,2028-07-29
7243,1235,6008,1999,7,30,xyz,2028-07-30
1794,5651,-3857,1999,7,31,xyz,2028-07-31
1704,3015,-1311,1999,8,1,xyz,2028-08-01
7148,1352,5796,1999,8,2,xyz,2028-08-02
7899,9294,-1395,1999,8,3,xyz,2028-08-03
5911,1331,4580,1999,8,4,xyz,2028-08-04
4421,3409,1012,1999,8,5,xyz,2028-08-05
1005,3339,-2334,1999,8,6,xyz,2028-08-06
4114,566,3548,1999,8,7,xyz,2028-08-07
5663,530,5133,1999,8,8,xyz,2028-08-08
4907,6723,-1816,1999,8,9,xyz,2028-08-09
8057,2690,5367,1999,8,10,xyz,2028-08-10
3548,3341,207,1999,8,11,xyz,2028-08-11
9938,6977,2961,1999,8,12,xyz,2028-08-12
2842,7246,-4404,1999,8,13,xyz,2028-08-13
4264,2804,1460,1999,8,14,xyz,2028-08-14
2441,5860,-3419,1999,8,15,xyz,2028-08-15
8421,1604,6817,1999,8,16,xyz,2028-08-16
3980,5876,-1896,1999,8,17,xyz,2028-08-17
1291,4107,-2816,1999,8,18,xyz,2028-08-18
2426,3962,-1536,1999,8,19,xyz,2028-08-19
9581,7656,1925,1999,8,20,xyz,2028-08-20
4819,4700,119,1999,8,21,xyz,2028-08-21
1345,1251,94,1999,8,22,xyz,2028-08-22
3127,9257,-6130,1999,8,23,xyz,2028-08-23
1500,5578,-4078,1999,8,24,xyz,2028-08-24
8916,4381,4535,1999,8,25,xyz,2028-08-25
4526,1582,2944,1999,8,26,xyz,2028-08-26
6554,6586,-32,1999,8,27,xyz,2028-08-27
5543,5495,48,1999,8,28,xyz,2028-08-28
9445,3063,6382,1999,8,29,xyz,2028-08-29
7577,4250,3327,1999,8,30,xyz,2028-08-30
2327,5530,-3203,1999,8,31,xyz,2028-08-31
7720,8932,-1212,1999,9,1,xyz,2028-09-01
6259,9722,-3463,1999,9,2,xyz,2028-09-02
1644,5437,-3793,1999,9,3,xyz,2028-09-03
2769,2307,462,1999,9,4,xyz,2028-09-04
3036,1349,1687,1999,9,5,xyz,2028-09-05
9718,7800,1918,1999,9,6,xyz,2028-09-06
4783,8128,-3345,1999,9,7,xyz,2028-09-07
9433,2568,6865,1999,9,8,xyz,2028-09-08
5528,3660,1868,1999,9,9,xyz,2028-09-09
2139,9931,-7792,1999,9,10,xyz,2028-09-10
5111,1529,3582,1999,9,11,xyz,2028-09-11
5847,9523,-3676,1999,9,12,xyz,2028-09-12
3926,4445,-519,1999,9,13,xyz,2028-09-13
5049,6594,-1545,1999,9,14,xyz,2028-09-14
3045,8039,-4994,1999,9,15,xyz,2028-09-15
7392,8356,-964,1999,9,16,xyz,2028-09-16
2173,1881,292,1999,9,17,xyz,2028-09-17
6838,1080,5758,1999,9,18,xyz,2028-09-18
3959,1934,2025,1999,9,19,xyz,2028-09-19
4996,5477,-481,1999,9,20,xyz,2028-09-20
8164,1991,6173,1999,9,21,xyz,2028-09-21
7276,5011,2265,1999,9,22,xyz,2028-09-22
7780,9562,-1782,1999,9,23,xyz,2028-09-23
2684,1811,873,1999,9,24,xyz,2028-09-24
6464,1034,5430,1999,9,25,xyz,2028-09-25
2851,5820,-2969,1999,9,26,xyz,2028-09-26
1850,4462,-2612,1999,9,27,xyz,2028-09-27
5621,1837,3784,1999,9,28,xyz,2028-09-28
7478,9890,-2412,1999,9,29,xyz,2028-09-29
3103,9081,-5978,1999,9,30,xyz,2028-09-30
8513,8162,351,1999,10,1,xyz,2028-10-01
4725,6116,-1391,1999,10,2,xyz,2028-10-02
8556,9448,-892,1999,10,3,xyz,2028-10-03
5810,6868,-1058,1999,10,4,xyz,2028-10-04
1150,9911,-8761,1999,10,5,xyz,2028-10-05
7080,6056,1024,1999,10,6,xyz,2028-10-06
7323,558,6765,1999,10,7,xyz,2028-10-07
1792,8565,-6773,1999,10,8,xyz,2028-10-08
3977,4375,-398,1999,10,9,xyz,2028-10-09
5646,4014,1632,1999,10,10,xyz,2028-10-10
1311,620,691,1999,10,11,xyz,2028-10-11
2560,3130,-570,1999,10,12,xyz,2028-10-12
4759,2439,2320,1999,10,13,xyz,2028-10-13
8410,9531,-1121,1999,10,14,xyz,2028-10-14
4208,8646,-4438,1999,10,15,xyz,2028-10-15
4876,2188,2688,1999,10,16,xyz,2028-10-16
4698,631,4067,1999,10,17,xyz,2028-10-17
7858,7947,-89,1999,10,18,xyz,2028-10-18
2203,4528,-2325,1999,10,19,xyz,2028-10-19
4796,2030,2766,1999,10,20,xyz,2028-10-20
1969,5529,-3560,1999,10,21,xyz,2028-10-21
8812,2497,6315,1999,10,22,xyz,2028-10-22
8624,7151,1473,1999,10,23,xyz,2028-10-23
6496,7184,-688,1999,10,24,xyz,2028-10-24
1021,794,227,1999,10,25,xyz,2028-10-25
1625,7052,-5427,1999,10,26,xyz,2028-10-26
1124,4781,-3657,1999,10,27,xyz,2028-10-27
8874,3438,5436,1999,10,28,xyz,2028-10-28
7106,9719,-2613,1999,10,29,xyz,2028-10-29
7425,9015,-1590,1999,10,30,xyz,2028-10-30
2483,3372,-889,1999,10,31,xyz,2028-10-31
4763,3763,1000,1999,11,1,xyz,2028-11-01
7569,4301,3268,1999,11,2,xyz,2028-11-02
9309,9462,-153,1999,11,3,xyz,2028-11-03
6863,2859,4004,1999,11,4,xyz,2028-11-04
7653,1832,5821,1999,11,5,xyz,2028-11-05
5429,5427,2,1999,11,6,xyz,2028-11-06
9211,6566,2645,1999,11,7,xyz,2028-11-07
6418,4846,1572,1999,11,8,xyz,2028-11-08
1505,9110,-7605,1999,11,9,xyz,2028-11-09
8887,5461,3426,1999,11,10,xyz,2028-11-10
8227,9585,-1358,1999,11,11,xyz,2028-11-11
3446,8338,-4892,1999,11,12,xyz,2028-11-12
5525,6737,-1212,1999,11,13,xyz,2028-11-13
2716,8442,-5726,1999,11,14,xyz,2028-11-14
7483,6441,1042,1999,11,15,xyz,2028-11-15
9162,5299,3863,1999,11,16,xyz,2028-11-16
7382,731,6651,1999,11,17,xyz,2028-11-17
5285,2616,2669,1999,11,18,xyz,2028-11-18
6656,4821,1835,1999,11,19,xyz,2028-11-19
9166,6233,2933,1999,11,20,xyz,2028-11-20
2423,8948,-6525,1999,11,21,xyz,2028-11-21
9180,9859,-679,1999,11,22,xyz,2028-11-22
2231,2926,-695,1999,11,23,xyz,2028-11-23
5514,506,5008,1999,11,24,xyz,2028-11-24
3396,6731,-3335,1999,11,25,xyz,2028-11-25
1226,9821,-8595,1999,11,26,xyz,2028-11-26
6370,3912,2458,1999,11,27,xyz,2028-11-27
3103,7113,-4010,1999,11,28,xyz,2028-11-28
3312,6179,-2867,1999,11,29,xyz,2028-11-29
8965,7205,1760,1999,11,30,xyz,2028-11-30
4560,8956,-4396,1999,12,1,xyz,2028-12-01
9961,2007,7954,1999,12,2,xyz,2028-12-02
2112,9488,-7376,1999,12,3,xyz,2028-12-03
1258,7812,-6554,1999,12,4,xyz,2028-12-04
7101,3120,3981,1999,12,5,xyz,2028-12-05
7895,5771,2124,1999,12,6,xyz,2028-12-06
7317,7160,157,1999,12,7,xyz,2028-12-07
6750,7001,-251,1999,12,8,xyz,2028-12-08
6622,3219,3403,1999,12,9,xyz,2028-12-09
5848,6222,-374,1999,12,10,xyz,2028-12-10
6279,6961,-682,1999,12,11,xyz,2028-12-11
5472,6720,-1248,1999,12,12,xyz,2028-12-12
4709,3394,1315,1999,12,13,xyz,2028-12-13
3648,9266,-5618,1999,12,14,xyz,2028-12-14
1004,1881,-877,1999,12,15,xyz,2028-12-15
6565,7559,-994,1999,12,16,xyz,2028-12-16
6029,8699,-2670,1999,12,17,xyz,2028-12-17
1105,586,519,1999,12,18,xyz,2028-12-18
6193,3630,2563,1999,12,19,xyz,2028-12-19
4190,1523,2667,1999,12,20,xyz,2028-12-20
6990,6905,85,1999,12,21,xyz,2028-12-21
3778,5939,-2161,1999,12,22,xyz,2028-12-22
2507,3111,-604,1999,12,23,xyz,2028-12-23
9457,4091,5366,1999,12,24,xyz,2028-12-24
4553,9782,-5229,1999,12,25,xyz,2028-12-25
1977,2366,-389,1999,12,26,xyz,2028-12-26
9759,6726,3033,1999,12,27,xyz,2028-12-27
3999,4404,-405,1999,12,28,xyz,2028-12-28
4841,9676,-4835,1999,12,29,xyz,2028-12-29
9438,9381,57,1999,12,30,xyz,2028-12-30
1309,1942,-633,1999,12,31,xyz,2028-12-31
2417,646,1771,2000,1,1,xyz,2029-01-01
8434,7159,1275,2000,1,2,xyz,2029-01-02
4111,6420,-2309,2000,1,3,xyz,2029-01-03
2180,3979,-1799,2000,1,4,xyz,2029-01-04
2348,5770,-3422,2000,1,5,xyz,2029-01-05
5415,3375,2040,2000,1,6,xyz,2029-01-06
3349,2747,602,2000,1,7,xyz,2029-01-07
8440,2693,5747,2000,1,8,xyz,2029-01-08
6875,9910,-3035,2000,1,9,xyz,2029-01-09
4166,2887,1279,2000,1,10,xyz,2029-01-10
1760,4715,-2955,2000,1,11,xyz,2029-01-11
7886,7280,606,2000,1,12,xyz,2029-01-12
3072,3150,-78,2000,1,13,xyz,2029-01-13
4595,5293,-698,2000,1,14,xyz,2029-01-14
3231,3663,-432,2000,1,15,xyz,2029-01-15
8080,767,7313,2000,1,16,xyz,2029-01-16
6950,513,6437,2000,1,17,xyz,2029-01-17
3820,4680,-860,2000,1,18,xyz,2029-01-18
4761,5531,-770,2000,1,19,xyz,2029-01-19
5631,6023,-392,2000,1,20,xyz,2029-01-20
1759,7050,-5291,2000,1,21,xyz,2029-01-21
3875,1822,2053,2000,1,22,xyz,2029-01-22
7759,8772,-1013,2000,1,23,xyz,2029-01-23
5293,7035,-1742,2000,1,24,xyz,2029-01-24
7066,6582,484,2000,1,25,xyz,2029-01-25
5882,9935,-4053,2000,1,26,xyz,2029-01-26
7999,1465,6534,2000,1,27,xyz,2029-01-27
3891,8101,-4210,2000,1,28,xyz,2029-01-28
1952,2209,-257,2000,1,29,xyz,2029-01-29
7839,983,6856,2000,1,30,xyz,2029-01-30
5297,4428,869,2000,1,31,xyz,2029-01-31
9974,5100,4874,2000,2,1,xyz,2029-02-01
5370,4996,374,2000,2,2,xyz,2029-02-02
4597,3796,801,2000,2,3,xyz,2029-02-03
3863,2943,920,2000,2,4,xyz,2029-02-04
8323,9511,-1188,2000,2,5,xyz,2029-02-05
9319,831,8488,2000,2,6,xyz,2029-02-06
6101,2905,3196,2000,2,7,xyz,2029-02-07
9259,4045,5214,2000,2,8,xyz,2029-02-08
4053,6024,-1971,2000,2,9,xyz,2029-02-09
5470,7834,-2364,2000,2,10,xyz,2029-02-10
5442,1790,3652,2000,2,11,xyz,2029-02-11
6251,5117,1134,2000,2,12,xyz,2029-02-12
6260,3599,2661,2000,2,13,xyz,2029-02-13
8413,4925,3488,2000,2,14,xyz,2029-02-14
8090,4551,3539,2000,2,15,xyz,2029-02-15
6765,2916,3849,2000,2,16,xyz,2029-02-16
1857,3996,-2139,2000,2,17,xyz,2029-02-17
8708,1368,7340,2000,2,18,xyz,2029-02-18
6280,5431,849,2000,2,19,xyz,2029-02-19
8234,6595,1639,2000,2,20,xyz,2029-02-20
4711,7803,-3092,2000,2,21,xyz,2029-02-21
5638,5684,-46,2000,2,22,xyz,2029-02-22
1124,3994,-2870,2000,2,23,xyz,2029-02-23
2947,9781,-6834,2000,2,24,xyz,2029-02-24
4243,9394,-5151,2000,2,25,xyz,2029-02-25
6507,6729,-222,2000,2,26,xyz,2029-02-26
1669,4731,-3062,2000,2,27,xyz,2029-02-27
8676,615,8061,2000,2,28,xyz,2029-02-28
1010,7386,-6376,2000,3,1,xyz,2029-03-01
2867,4597,-1730,2000,3,2,xyz,2029-03-02
2433,3141,-708,2000,3,3,xyz,2029-03-03
8831,8466,365,2000,3,4,xyz,2029-03-04
1613,669,944,2000,3,5,xyz,2029-03-05
4882,8754,-3872,2000,3,6,xyz,2029-03-06
6404,9082,-2678,2000,3,7,xyz,2029-03-07
4567,2198,2369,2000,3,8,xyz,2029-03-08
6061,1152,4909,2000,3,9,xyz,2029-03-09
8191,6062,2129,2000,3,10,xyz,2029-03-10
9703,9756,-53,2000,3,11,xyz,2029-03-11
7317,5389,1928,2000,3,12,xyz,2029-03-12
2899,6143,-3244,2000,3,13,xyz,2029-03-13
7506,5431,2075,2000,3,14,xyz,2029-03-14
8468,7676,792,2000,3,15,xyz,2029-03-15
5463,3151,2312,2000,3,16,xyz,2029-03-16
2650,7843,-5193,2000,3,17,xyz,2029-03-17
6093,6268,-175,2000,3,18,xyz,2029-03-18
3529,5130,-1601,2000,3,19,xyz,2029-03-19
8518,7108,1410,2000,3,20,xyz,2029-03-20
3249,965,2284,2000,3,21,xyz,2029-03-21
3483,8508,-5025,2000,3,22,xyz,2029-03-22
2363,1040,1323,2000,3,23,xyz,2029-03-23
6903,839,6064,2000,3,24,xyz,2029-03-24
6873,8666,-1793,2000,3,25,xyz,2029-03-25
6720,4394,2326,2000,3,26,xyz,2029-03-26
2046,3371,-1325,2000,3,27,xyz,2029-03-27
9393,9551,-158,2000,3,28,xyz,2029-03-28
4518,4193,325,2000,3,29,xyz,2029-03-29
1136,5498,-4362,2000,3,30,xyz,2029-03-30
5754,3997,1757,2000,3,31,xyz,2029-03-31
5954,9580,-3626,2000,4,1,xyz,2029-04-01
1647,6189,-4542,2000,4,2,xyz,2029-04-02
3972,9211,-5239,2000,4,3,xyz,2029-04-03
2647,1275,1372,2000,4,4,xyz,2029-04-04
8741,7840,901,2000,4,5,xyz,2029-04-05
5441,4626,815,2000,4,6,xyz,2029-04-06
3258,1628,1630,2000,4,7,xyz,2029-04-07
8264,1749,6515,2000,4,8,xyz,2029-04-08
1299,764,535,2000,4,9,xyz,2029-04-09
3908,6242,-2334,2000,4,10,xyz,2029-04-10
5658,7652,-1994,2000,4,11,xyz,2029-04-11
5399,4379,1020,2000,4,12,xyz,2029-04-12
3789,1150,2639,2000,4,13,xyz,2029-04-13
6565,2906,3659,2000,4,14,xyz,2029-04-14
2354,5178,-2824,2000,4,15,xyz,2029-04-15
9593,6768,2825,2000,4,16,xyz,2029-04-16
7408,3338,4070,2000,4,17,xyz,2029-04-17
5352,4317,1035,2000,4,18,xyz,2029-04-18
5791,8739,-2948,2000,4,19,xyz,2029-04-19
8648,7486,1162,2000,4,20,xyz,2029-04-20
6315,2100,4215,2000,4,21,xyz,2029-04-21
8023,5466,2557,2000,4,22,xyz,2029-04-22
2328,6538,-4210,2000,4,23,xyz,2029-04-23
5530,4590,940,2000,4,24,xyz,2029-04-24
8038,7698,340,2000,4,25,xyz,2029-04-25
8641,4386,4255,2000,4,26,xyz,2029-04-26
1787,2930,-1143,2000,4,27,xyz,2029-04-27
1687,5928,-4241,2000,4,28,xyz,2029-04-28
9722,2089,7633,2000,4,29,xyz,2029-04-29
3660,7760,-4100,2000,4,30,xyz,2029-04-30
6966,2722,4244,2000,5,1,xyz,2029-05-01
2897,1425,1472,2000,5,2,xyz,2029-05-02
3301,8066,-4765,2000,5,3,xyz,2029-05-03
6837,3182,3655,2000,5,4,xyz,2029-05-04
1266,5348,-4082,2000,5,5,xyz,2029-05-05
8931,4104,4827,2000,5,6,xyz,2029-05-06
2321,908,1413,2000,5,7,xyz,2029-05-07
2384,7105,-4721,2000,5,8,xyz,2029-05-08
4402,8897,-4495,2000,5,9,xyz,2029-05-09
4739,596,4143,2000,5,10,xyz,2029-05-10
1839,8968,-7129,2000,5,11,xyz,2029-05-11
5807,5198,609,2000,5,12,xyz,2029-05-12
6308,657,5651,2000,5,13,xyz,2029-05-13
2099,7869,-5770,2000,5,14,xyz,2029-05-14
6516,1944,4572,2000,5,15,xyz,2029-05-15
5902,4109,1793,2000,5,16,xyz,2029-05-16
6959,3970,2989,2000,5,17,xyz,2029-05-17
6925,7018,-93,2000,5,18,xyz,2029-05-18
1010,5773,-4763,2000,5,19,xyz,2029-05-19
8508,1622,6886,2000,5,20,xyz,2029-05-20
5840,5272,568,2000,5,21,xyz,2029-05-21
6963,4947,2016,2000,5,22,xyz,2029-05-22
7151,7077,74,2000,5,23,xyz,2029-05-23
1588,2153,-565,2000,5,24,xyz,2029-05-24
9377,5224,4153,2000,5,25,xyz,2029-05-25
6530,1527,5003,2000,5,26,xyz,2029-05-26
9697,6070,3627,2000,5,27,xyz,2029-05-27
3512,8927,-5415,2000,5,28,xyz,2029-05-28
4489,4440,49,2000,5,29,xyz,2029-05-29
7820,2292,5528,2000,5,30,xyz,2029-05-30
4178,4143,35,2000,5,31,xyz,2029-05-31
7931,3706,4225,2000,6,1,xyz,2029-06-01
8400,5211,3189,2000,6,2,xyz,2029-06-02
9507,910,8597,2000,6,3,xyz,2029-06-03
7168,7128,40,2000,6,4,xyz,2029-06-04
5392,2961,2431,2000,6,5,xyz,2029-06-05
7102,5869,1233,2000,6,6,xyz,2029-06-06
1711,3878,-2167,2000,6,7,xyz,2029-06-07
5355,3964,1391,2000,6,8,xyz,2029-06-08
6744,2149,4595,2000,6,9,xyz,2029-06-09
2613,9726,-7113,2000,6,10,xyz,2029-06-10
7587,1212,6375,2000,6,11,xyz,2029-06-11
4280,2987,1293,2000,6,12,xyz,2029-06-12
2822,7939,-5117,2000,6,13,xyz,2029-06-13
9116,3794,5322,2000,6,14,xyz,2029-06-14
8713,7676,1037,2000,6,15,xyz,2029-06-15
7271,7588,-317,2000,6,16,xyz,2029-06-16
6946,2877,4069,2000,6,17,xyz,2029-06-17
9268,1061,8207,2000,6,18,xyz,2029-06-18
3572,6853,-3281,2000,6,19,xyz,2029-06-19
8285,1447,6838,2000,6,20,xyz,2029-06-20
5839,5945,-106,2000,6,21,xyz,2029-06-21
1803,4121,-2318,2000,6,22,xyz,2029-06-22
1204,2682,-1478,2000,6,23,xyz,2029-06-23
4986,4882,104,2000,6,24,xyz,2029-06-24
8922,2786,6136,2000,6,25,xyz,2029-06-25
4276,8102,-3826,2000,6,26,xyz,2029-06-26
9710,4432,5278,2000,6,27,xyz,2029-06-27
9863,4848,5015,2000,6,28,xyz,2029-06-28
4795,8461,-3666,2000,6,29,xyz,2029-06-29
1980,3631,-1651,2000,6,30,xyz,2029-06-30
8578,642,7936,2000,7,1,xyz,2029-07-01
4957,6576,-1619,2000,7,2,xyz,2029-07-02
8781,5508,3273,2000,7,3,xyz,2029-07-03
7154,9186,-2032,2000,7,4,xyz,2029-07-04
6107,1765,4342,2000,7,5,xyz,2029-07-05
6781,3586,3195,2000,7,6,xyz,2029-07-06
7031,6031,1000,2000,7,7,xyz,2029-07-07
5971,5945,26,2000,7,8,xyz,2029-07-08
4542,7540,-2998,2000,7,9,xyz,2029-07-09
7572,5621,1951,2000,7,10,xyz,2029-07-10
2072,4113,-2041,2000,7,11,xyz,2029-07-11
5751,1161,4590,2000,7,12,xyz,2029-07-12
1090,1117,-27,2000,7,13,xyz,2029-07-13
9173,4412,4761,2000,7,14,xyz,2029-07-14
1557,6050,-4493,2000,7,15,xyz,2029-07-15
6233,5415,818,2000,7,16,xyz,2029-07-16
2972,9884,-6912,2000,7,17,xyz,2029-07-17
9768,7649,2119,2000,7,18,xyz,2029-07-18
7383,3061,4322,2000,7,19,xyz,2029-07-19
3648,3000,648,2000,7,20,xyz,2029-07-20
2942,9691,-6749,2000,7,21,xyz,2029-07-21
6261,5972,289,2000,7,22,xyz,2029-07-22
6301,8381,-2080,2000,7,23,xyz,2029-07-23
6282,3948,2334,2000,7,24,xyz,2029-07-24
9194,1073,8121,2000,7,25,xyz,2029-07-25
8842,5846,2996,2000,7,26,xyz,2029-07-26
6749,2220,4529,2000,7,27,xyz,2029-07-27
1128,2743,-1615,2000,7,28,xyz,2029-07-28
6498,7501,-1003,2000,7,29,xyz,2029-07-29
9405,2194,7211,2000,7,30,xyz,2029-07-30
5833,3529,2304,2000,7,31,xyz,2029-07-31
3596,1179,2417,2000,8,1,xyz,2029-08-01
6291,1214,5077,2000,8,2,xyz,2029-08-02
2293,2988,-695,2000,8,3,xyz,2029-08-03
8215,9317,-1102,2000,8,4,xyz,2029-08-04
1927,6925,-4998,2000,8,5,xyz,2029-08-05
4102,2188,1914,2000,8,6,xyz,2029-08-06
8145,8938,-793,2000,8,7,xyz,2029-08-07
1654,7893,-6239,2000,8,8,xyz,2029-08-08
9239,2770,6469,2000,8,9,xyz,2029-08-09
2081,4711,-2630,2000,8,10,xyz,2029-08-10
6842,3336,3506,2000,8,11,xyz,2029-08-11
6293,2039,4254,2000,8,12,xyz,2029-08-12
1127,2439,-1312,2000,8,13,xyz,2029-08-13
2058,4270,-2212,2000,8,14,xyz,2029-08-14
4221,4816,-595,2000,8,15,xyz,2029-08-15
3464,5416,-1952,2000,8,16,xyz,2029-08-16
3767,4866,-1099,2000,8,17,xyz,2029-08-17
1676,3507,-1831,2000,8,18,xyz,2029-08-18
2344,2828,-484,2000,8,19,xyz,2029-08-19
8936,5427,3509,2000,8,20,xyz,2029-08-20
4324,8371,-4047,2000,8,21,xyz,2029-08-21
6774,8240,-1466,2000,8,22,xyz,2029-08-22
7486,4168,3318,2000,8,23,xyz,2029-08-23
3162,8596,-5434,2000,8,24,xyz,2029-08-24
8870,9134,-264,2000,8,25,xyz,2029-08-25
9845,4763,5082,2000,8,26,xyz,2029-08-26
8230,2043,6187,2000,8,27,xyz,2029-08-27
9107,1994,7113,2000,8,28,xyz,2029-08-28
8202,8381,-179,2000,8,29,xyz,2029-08-29
9281,5209,4072,2000,8,30,xyz,2029-08-30
1005,4523,-3518,2000,8,31,xyz,2029-08-31
4848,2565,2283,2000,9,1,xyz,2029-09-01
7020,7852,-832,2000,9,2,xyz,2029-09-02
6773,5518,1255,2000,9,3,xyz,2029-09-03
4900,4267,633,2000,9,4,xyz,2029-09-04
6532,7776,-1244,2000,9,5,xyz,2029-09-05
8278,1507,6771,2000,9,6,xyz,2029-09-06
9699,1374,8325,2000,9,7,xyz,2029-09-07
2050,982,1068,2000,9,8,xyz,2029-09-08
1596,7531,-5935,2000,9,9,xyz,2029-09-09
5303,9194,-3891,2000,9,10,xyz,2029-09-10
4069,8055,-3986,2000,9,11,xyz,2029-09-11
3252,6616,-3364,2000,9,12,xyz,2029-09-12
5310,8189,-2879,2000,9,13,xyz,2029-09-13
9897,2381,7516,2000,9,14,xyz,2029-09-14
2220,4476,-2256,2000,9,15,xyz,2029-09-15
9049,6527,2522,2000,9,16,xyz,2029-09-16
1902,968,934,2000,9,17,xyz,2029-09-17
5514,1832,3682,2000,9,18,xyz,2029-09-18
6085,4930,1155,2000,9,19,xyz,2029-09-19
9655,9924,-269,2000,9,20,xyz,2029-09-20
5424,8947,-3523,2000,9,21,xyz,2029-09-21
4603,2282,2321,2000,9,22,xyz,2029-09-22
5746,5703,43,2000,9,23,xyz,2029-09-23
4038,4412,-374,2000,9,24,xyz,2029-09-24
6795,3839,2956,2000,9,25,xyz,2029-09-25
6206,9953,-3747,2000,9,26,xyz,2029-09-26
5443,7430,-1987,2000,9,27,xyz,2029-09-27
2677,9857,-7180,2000,9,28,xyz,2029-09-28
5670,2558,3112,2000,9,29,xyz,2029-09-29
2837,6688,-3851,2000,9,30,xyz,2029-09-30
6590,7935,-1345,2000,10,1,xyz,2029-10-01
8380,6476,1904,2000,10,2,xyz,2029-10-02
6537,7474,-937,2000,10,3,xyz,2029-10-03
9342,9070,272,2000,10,4,xyz,2029-10-04
5387,1107,4280,2000,10,5,xyz,2029-10-05
2999,2495,504,2000,10,6,xyz,2029-10-06
9019,7043,1976,2000,10,7,xyz,2029-10-07
8722,3264,5458,2000,10,8,xyz,2029-10-08
2393,2640,-247,2000,10,9,xyz,2029-10-09
6634,8514,-1880,2000,10,10,xyz,2029-10-10
4440,7623,-3183,2000,10,11,xyz,2029-10-11
8566,6248,2318,2000,10,12,xyz,2029-10-12
3359,2607,752,2000,10,13,xyz,2029-10-13
4073,2262,1811,2000,10,14,xyz,2029-10-14
9018,3815,5203,2000,10,15,xyz,2029-10-15
8961,2667,6294,2000,10,16,xyz,2029-10-16
3718,7443,-3725,2000,10,17,xyz,2029-10-17
7713,2048,5665,2000,10,18,xyz,2029-10-18
9019,5345,3674,2000,10,19,xyz,2029-10-19
3563,9511,-5948,2000,10,20,xyz,2029-10-20
1681,7239,-5558,2000,10,21,xyz,2029-10-21
7802,2962,4840,2000,10,22,xyz,2029-10-22
7224,4927,2297,2000,10,23,xyz,2029-10-23
8547,8780,-233,2000,10,24,xyz,2029-10-24
6033,7951,-1918,2000,10,25,xyz,2029-10-25
5776,4453,1323,2000,10,26,xyz,2029-10-26
7719,7903,-184,2000,10,27,xyz,2029-10-27
4898,6281,-1383,2000,10,28,xyz,2029-10-28
6538,7403,-865,2000,10,29,xyz,2029-10-29
3048,4594,-1546,2000,10,30,xyz,2029-10-30
1382,6106,-4724,2000,10,31,xyz,2029-10-31
9771,9303,468,2000,11,1,xyz,2029-11-01
4514,4472,42,2000,11,2,xyz,2029-11-02
3030,1609,1421,2000,11,3,xyz,2029-11-03
7875,7717,158,2000,11,4,xyz,2029-11-04
6843,8642,-1799,2000,11,5,xyz,2029-11-05
7453,2658,4795,2000,11,6,xyz,2029-11-06
1718,6081,-4363,2000,11,7,xyz,2029-11-07
2349,2196,153,2000,11,8,xyz,2029-11-08
9842,4550,5292,2000,11,9,xyz,2029-11-09
6453,1742,4711,2000,11,10,xyz,2029-11-10
6979,4289,2690,2000,11,11,xyz,2029-11-11
9884,1351,8533,2000,11,12,xyz,2029-11-12
4102,1321,2781,2000,11,13,xyz,2029-11-13
7212,4547,2665,2000,11,14,xyz,2029-11-14
1414,9303,-7889,2000,11,15,xyz,2029-11-15
8174,5625,2549,2000,11,16,xyz,2029-11-16
6881,751,6130,2000,11,17,xyz,2029-11-17
7714,6930,784,2000,11,18,xyz,2029-11-18
5838,8736,-2898,2000,11,19,xyz,2029-11-19
3678,4157,-479,2000,11,20,xyz,2029-11-20
4268,5447,-1179,2000,11,21,xyz,2029-11-21
6017,6843,-826,2000,11,22,xyz,2029-11-22
7857,4666,3191,2000,11,23,xyz,2029-11-23
4767,4534,233,2000,11,24,xyz,2029-11-24
9829,6786,3043,2000,11,25,xyz,2029-11-25
5684,5084,600,2000,11,26,xyz,2029-11-26
3413,7322,-3909,2000,11,27,xyz,2029-11-27
6295,7621,-1326,2000,11,28,xyz,2029-11-28
8316,7670,646,2000,11,29,xyz,2029-11-29
6157,7052,-895,2000,11,30,xyz,2029-11-30
5991,9068,-3077,2000,12,1,xyz,2029-12-01
8916,3476,5440,2000,12,2,xyz,2029-12-02
7319,1491,5828,2000,12,3,xyz,2029-12-03
7923,8910,-987,2000,12,4,xyz,2029-12-04
5140,8667,-3527,2000,12,5,xyz,2029-12-05
8520,9621,-1101,2000,12,6,xyz,2029-12-06
9519,1846,7673,2000,12,7,xyz,2029-12-07
1631,5072,-3441,2000,12,8,xyz,2029-12-08
4579,9767,-5188,2000,12,9,xyz,2029-12-09
8100,3025,5075,2000,12,10,xyz,2029-12-10
7096,2283,4813,2000,12,11,xyz,2029-12-11
2865,2466,399,2000,12,12,xyz,2029-12-12
8807,7713,1094,2000,12,13,xyz,2029-12-13
5568,4539,1029,2000,12,14,xyz,2029-12-14
9537,5859,3678,2000,12,15,xyz,2029-12-15
2390,8961,-6571,2000,12,16,xyz,2029-12-16
3815,6666,-2851,2000,12,17,xyz,2029-12-17
2214,7965,-5751,2000,12,18,xyz,2029-12-18
7471,4107,3364,2000,12,19,xyz,2029-12-19
4744,4213,531,2000,12,20,xyz,2029-12-20
6767,4116,2651,2000,12,21,xyz,2029-12-21
5153,4819,334,2000,12,22,xyz,2029-12-22
1161,7760,-6599,2000,12,23,xyz,2029-12-23
2512,7977,-5465,2000,12,24,xyz,2029-12-24
5906,8720,-2814,2000,12,25,xyz,2029-12-25
8638,2811,5827,2000,12,26,xyz,2029-12-26
3592,3167,425,2000,12,27,xyz,2029-12-27
5788,3151,2637,2000,12,28,xyz,2029-12-28
7819,7893,-74,2000,12,29,xyz,2029-12-29
7844,7626,218,2000,12,30,xyz,2029-12-30
5451,1911,3540,2000,12,31,xyz,2029-12-31
3997,7428,-3431,2001,1,1,xyz,2030-01-01
6268,8507,-2239,2001,1,2,xyz,2030-01-02
2674,781,1893,2001,1,3,xyz,2030-01-03
5551,2356,3195,2001,1,4,xyz,2030-01-04
2423,2118,305,2001,1,5,xyz,2030-01-05
8208,9442,-1234,2001,1,6,xyz,2030-01-06
8606,1049,7557,2001,1,7,xyz,2030-01-07
4075,8215,-4140,2001,1,8,xyz,2030-01-08
2380,4449,-2069,2001,1,9,xyz,2030-01-09
4674,4988,-314,2001,1,10,xyz,2030-01-10
6909,9782,-2873,2001,1,11,xyz,2030-01-11
1168,5118,-3950,2001,1,12,xyz,2030-01-12
5081,4175,906,2001,1,13,xyz,2030-01-13
8127,6946,1181,2001,1,14,xyz,2030-01-14
2215,2154,61,2001,1,15,xyz,2030-01-15
6755,6062,693,2001,1,16,xyz,2030-01-16
7722,1611,6111,2001,1,17,xyz,2030-01-17
4330,9828,-5498,2001,1,18,xyz,2030-01-18
6948,5738,1210,2001,1,19,xyz,2030-01-19
9406,3868,5538,2001,1,20,xyz,2030-01-20
3383,6936,-3553,2001,1,21,xyz,2030-01-21
5484,4183,1301,2001,1,22,xyz,2030-01-22
2939,2836,103,2001,1,23,xyz,2030-01-23
8224,8208,16,2001,1,24,xyz,2030-01-24
1070,4256,-3186,2001,1,25,xyz,2030-01-25
9904,849,9055,2001,1,26,xyz,2030-01-26
9198,8552,646,2001,1,27,xyz,2030-01-27
3230,5124,-1894,2001,1,28,xyz,2030-01-28
3724,9756,-6032,2001,1,29,xyz,2030-01-29
7071,3313,3758,2001,1,30,xyz,2030-01-30
4098,4460,-362,2001,1,31,xyz,2030-01-31
1518,6013,-4495,2001,2,1,xyz,2030-02-01
7929,6101,1828,2001,2,2,xyz,2030-02-02
8497,948,7549,2001,2,3,xyz,2030-02-03
2450,4121,-1671,2001,2,4,xyz,2030-02-04
4924,4794,130,2001,2,5,xyz,2030-02-05
6240,5786,454,2001,2,6,xyz,2030-02-06
6945,8310,-1365,2001,2,7,xyz,2030-02-07
8605,7327,1278,2001,2,8,xyz,2030-02-08
6482,6252,230,2001,2,9,xyz,2030-02-09
5136,2878,2258,2001,2,10,xyz,2030-02-10
4046,845,3201,2001,2,11,xyz,2030-02-11
2322,5952,-3630,2001,2,12,xyz,2030-02-12
5563,5656,-93,2001,2,13,xyz,2030-02-13
6854,6137,717,2001,2,14,xyz,2030-02-14
6972,4800,2172,2001,2,15,xyz,2030-02-15
3039,2321,718,2001,2,16,xyz,2030-02-16
5315,7881,-2566,2001,2,17,xyz,2030-02-17
4065,7740,-3675,2001,2,18,xyz,2030-02-18
5143,5428,-285,2001,2,19,xyz,2030-02-19
3979,9172,-5193,2001,2,20,xyz,2030-02-20
9487,3328,6159,2001,2,21,xyz,2030-02-21
1891,5006,-3115,2001,2,22,xyz,2030-02-22
6766,1754,5012,2001,2,23,xyz,2030-02-23
7292,5468,1824,2001,2,24,xyz,2030-02-24
1160,9477,-8317,2001,2,25,xyz,2030-02-25
7172,8598,-1426,2001,2,26,xyz,2030-02-26
2566,6882,-4316,2001,2,27,xyz,2030-02-27
6377,585,5792,2001,2,28,xyz,2030-02-28
3581,2748,833,2001,3,1,xyz,2030-03-01
5314,7846,-2532,2001,3,2,xyz,2030-03-02
4604,4985,-381,2001,3,3,xyz,2030-03-03
6835,4009,2826,2001,3,4,xyz,2030-03-04
8926,1155,7771,2001,3,5,xyz,2030-03-05
1287,3801,-2514,2001,3,6,xyz,2030-03-06
9940,5956,3984,2001,3,7,xyz,2030-03-07
3709,7831,-4122,2001,3,8,xyz,2030-03-08
3166,3707,-541,2001,3,9,xyz,2030-03-09
8611,3212,5399,2001,3,10,xyz,2030-03-10
3140,3139,1,2001,3,11,xyz,2030-03-11
7189,9202,-2013,2001,3,12,xyz,2030-03-12
6679,9035,-2356,2001,3,13,xyz,2030-03-13
9033,5642,3391,2001,3,14,xyz,2030-03-14
5112,6372,-1260,2001,3,15,xyz,2030-03-15
1407,1167,240,2001,3,16,xyz,2030-03-16
3755,5154,-1399,2001,3,17,xyz,2030-03-17
6345,5639,706,2001,3,18,xyz,2030-03-18
5712,5050,662,2001,3,19,xyz,2030-03-19
4319,2019,2300,2001,3,20,xyz,2030-03-20
6988,9908,-2920,2001,3,21,xyz,2030-03-21
1336,9414,-8078,2001,3,22,xyz,2030-03-22
4246,6490,-2244,2001,3,23,xyz,2030-03-23
7093,3251,3842,2001,3,24,xyz,2030-03-24
8021,680,7341,2001,3,25,xyz,2030-03-25
5207,866,4341,2001,3,26,xyz,2030-03-26
7357,2534,4823,2001,3,27,xyz,2030-03-27
4990,6540,-1550,2001,3,28,xyz,2030-03-28
1534,5017,-3483,2001,3,29,xyz,2030-03-29
6171,8086,-1915,2001,3,30,xyz,2030-03-30
6371,6396,-25,2001,3,31,xyz,2030-03-31
1184,7512,-6328,2001,4,1,xyz,2030-04-01
8082,1955,6127,2001,4,2,xyz,2030-04-02
7182,3518,3664,2001,4,3,xyz,2030-04-03
6759,6686,73,2001,4,4,xyz,2030-04-04
1737,8026,-6289,2001,4,5,xyz,2030-04-05
5141,3193,1948,2001,4,6,xyz,2030-04-06
2891,9884,-6993,2001,4,7,xyz,2030-04-07
6801,9354,-2553,2001,4,8,xyz,2030-04-08
8208,842,7366,2001,4,9,xyz,2030-04-09
9109,8782,327,2001,4,10,xyz,2030-04-10
3131,8105,-4974,2001,4,11,xyz,2030-04-11
6335,7691,-1356,2001,4,12,xyz,2030-04-12
3486,2213,1273,2001,4,13,xyz,2030-04-13
8194,2694,5500,2001,4,14,xyz,2030-04-14
5070,7758,-2688,2001,4,15,xyz,2030-04-15
6248,3578,2670,2001,4,16,xyz,2030-04-16
5748,4151,1597,2001,4,17,xyz,2030-04-17
4335,8845,-4510,2001,4,18,xyz,2030-04-18
9617,9689,-72,2001,4,19,xyz,2030-04-19
9544,7074,2470,2001,4,20,xyz,2030-04-20
3091,4373,-1282,2001,4,21,xyz,2030-04-21
9470,8286,1184,2001,4,22,xyz,2030-04-22
7400,1798,5602,2001,4,23,xyz,2030-04-23
1536,7653,-6117,2001,4,24,xyz,2030-04-24
3621,4244,-623,2001,4,25,xyz,2030-04-25
2964,3824,-860,2001,4,26,xyz,2030-04-26
5253,5021,232,2001,4,27,xyz,2030-04-27
8968,7736,1232,2001,4,28,xyz,2030-04-28
8685,2699,5986,2001,4,29,xyz,2030-04-29
6238,6268,-30,2001,4,30,xyz,2030-04-30
1277,7312,-6035,2001,5,1,xyz,2030-05-01
1805,6778,-4973,2001,5,2,xyz,2030-05-02
9149,769,8380,2001,5,3,xyz,2030-05-03
4336,609,3727,2001,5,4,xyz,2030-05-04
8496,5967,2529,2001,5,5,xyz,2030-05-05
8694,9938,-1244,2001,5,6,xyz,2030-05-06
5967,3088,2879,2001,5,7,xyz,2030-05-07
7987,8708,-721,2001,5,8,xyz,2030-05-08
3540,8591,-5051,2001,5,9,xyz,2030-05-09
9188,5429,3759,2001,5,10,xyz,2030-05-10
2353,5015,-2662,2001,5,11,xyz,2030-05-11
3296,4458,-1162,2001,5,12,xyz,2030-05-12
9671,3315,6356,2001,5,13,xyz,2030-05-13
3041,9727,-6686,2001,5,14,xyz,2030-05-14
3720,854,2866,2001,5,15,xyz,2030-05-15
7442,1849,5593,2001,5,16,xyz,2030-05-16
1490,5476,-3986,2001,5,17,xyz,2030-05-17
4161,6365,-2204,2001,5,18,xyz,2030-05-18
1341,2402,-1061,2001,5,19,xyz,2030-05-19
6646,5363,1283,2001,5,20,xyz,2030-05-20
6984,9771,-2787,2001,5,21,xyz,2030-05-21
5289,3427,1862,2001,5,22,xyz,2030-05-22
8148,6066,2082,2001,5,23,xyz,2030-05-23
5645,5294,351,2001,5,24,xyz,2030-05-24
8428,4945,3483,2001,5,25,xyz,2030-05-25
6235,8303,-2068,2001,5,26,xyz,2030-05-26
5294,3619,1675,2001,5,27,xyz,2030-05-27
6475,2493,3982,2001,5,28,xyz,2030-05-28
8940,3272,5668,2001,5,29,xyz,2030-05-29
3991,3672,319,2001,5,30,xyz,2030-05-30
4977,2273,2704,2001,5,31,xyz,2030-05-31
4281,4544,-263,2001,6,1,xyz,2030-06-01
2490,6291,-3801,2001,6,2,xyz,2030-06-02
4433,2144,2289,2001,6,3,xyz,2030-06-03
8055,3739,4316,2001,6,4,xyz,2030-06-04
8013,1971,6042,2001,6,5,xyz,2030-06-05
4856,6203,-1347,2001,6,6,xyz,2030-06-06
3774,8824,-5050,2001,6,7,xyz,2030-06-07
7772,3723,4049,2001,6,8,xyz,2030-06-08
8627,2490,6137,2001,6,9,xyz,2030-06-09
1220,6037,-4817,2001,6,10,xyz,2030-06-10
8774,2747,6027,2001,6,11,xyz,2030-06-11
7156,7080,76,2001,6,12,xyz,2030-06-12
8796,1125,7671,2001,6,13,xyz,2030-06-13
2178,1453,725,2001,6,14,xyz,2030-06-14
7630,6752,878,2001,6,15,xyz,2030-06-15
4640,3928,712,2001,6,16,xyz,2030-06-16
1160,1774,-614,2001,6,17,xyz,2030-06-17
7624,1754,5870,2001,6,18,xyz,2030-06-18
6365,1690,4675,2001,6,19,xyz,2030-06-19
4583,523,4060,2001,6,20,xyz,2030-06-20
8046,2292,5754,2001,6,21,xyz,2030-06-21
2207,7404,-5197,2001,6,22,xyz,2030-06-22
8193,2271,5922,2001,6,23,xyz,2030-06-23
9910,8788,1122,2001,6,24,xyz,2030-06-24
5774,8421,-2647,2001,6,25,xyz,2030-06-25
1277,4077,-2800,2001,6,26,xyz,2030-06-26
7973,4921,3052,2001,6,27,xyz,2030-06-27
5546,693,4853,2001,6,28,xyz,2030-06-28
8301,3124,5177,2001,6,29,xyz,2030-06-29
2028,7426,-5398,2001,6,30,xyz,2030-06-30
9181,8362,819,2001,7,1,xyz,2030-07-01
7911,6399,1512,2001,7,2,xyz,2030-07-02
5982,8120,-2138,2001,7,3,xyz,2030-07-03
4795,4599,196,2001,7,4,xyz,2030-07-04
4907,8792,-3885,2001,7,5,xyz,2030-07-05
2197,8764,-6567,2001,7,6,xyz,2030-07-06
3500,3593,-93,2001,7,7,xyz,2030-07-07
7371,1720,5651,2001,7,8,xyz,2030-07-08
8853,8954,-101,2001,7,9,xyz,2030-07-09
3946,1320,2626,2001,7,10,xyz,2030-07-10
9504,2047,7457,2001,7,11,xyz,2030-07-11
7775,3729,4046,2001,7,12,xyz,2030-07-12
6620,5040,1580,2001,7,13,xyz,2030-07-13
1779,8725,-6946,2001,7,14,xyz,2030-07-14
8535,7774,761,2001,7,15,xyz,2030-07-15
6093,519,5574,2001,7,16,xyz,2030-07-16
6911,6602,309,2001,7,17,xyz,2030-07-17
3254,9749,-6495,2001,7,18,xyz,2030-07-18
5021,7500,-2479,2001,7,19,xyz,2030-07-19
3631,4295,-664,2001,7,20,xyz,2030-07-20
1398,916,482,2001,7,21,xyz,2030-07-21
2556,8447,-5891,2001,7,22,xyz,2030-07-22
3333,2370,963,2001,7,23,xyz,2030-07-23
1062,5244,-4182,2001,7,24,xyz,2030-07-24
3640,4023,-383,2001,7,25,xyz,2030-07-25
3420,7696,-4276,2001,7,26,xyz,2030-07-26
3308,5112,-1804,2001,7,27,xyz,2030-07-27
1163,2765,-1602,2001,7,28,xyz,2030-07-28
2867,793,2074,2001,7,29,xyz,2030-07-29
1153,1838,-685,2001,7,30,xyz,2030-07-30
1106,6791,-5685,2001,7,31,xyz,2030-07-31
9020,8610,410,2001,8,1,xyz,2030-08-01
7857,1398,6459,2001,8,2,xyz,2030-08-02
4022,3000,1022,2001,8,3,xyz,2030-08-03
6673,6866,-193,2001,8,4,xyz,2030-08-04
9198,5848,3350,2001,8,5,xyz,2030-08-05
7492,9339,-1847,2001,8,6,xyz,2030-08-06
7928,5853,2075,2001,8,7,xyz,2030-08-07
3062,7906,-4844,2001,8,8,xyz,2030-08-08
6661,866,5795,2001,8,9,xyz,2030-08-09
8871,1471,7400,2001,8,10,xyz,2030-08-10
7514,1060,6454,2001,8,11,xyz,2030-08-11
1761,2724,-963,2001,8,12,xyz,2030-08-12
7919,9833,-1914,2001,8,13,xyz,2030-08-13
2532,1459,1073,2001,8,14,xyz,2030-08-14
4295,8304,-4009,2001,8,15,xyz,2030-08-15
1406,4241,-2835,2001,8,16,xyz,2030-08-16
4816,4262,554,2001,8,17,xyz,2030-08-17
5499,8292,-2793,2001,8,18,xyz,2030-08-18
1815,6921,-5106,2001,8,19,xyz,2030-08-19
1062,5409,-4347,2001,8,20,xyz,2030-08-20
9385,4433,4952,2001,8,21,xyz,2030-08-21
1255,6766,-5511,2001,8,22,xyz,2030-08-22
3476,626,2850,2001,8,23,xyz,2030-08-23
9251,6079,3172,2001,8,24,xyz,2030-08-24
5671,1091,4580,2001,8,25,xyz,2030-08-25
8701,5225,3476,2001,8,26,xyz,2030-08-26
8309,4438,3871,2001,8,27,xyz,2030-08-27
8712,6689,2023,2001,8,28,xyz,2030-08-28
6516,2283,4233,2001,8,29,xyz,2030-08-29
1826,602,1224,2001,8,30,xyz,2030-08-30
3781,2000,1781,2001,8,31,xyz,2030-08-31
9003,1531,7472,2001,9,1,xyz,2030-09-01
7083,2612,4471,2001,9,2,xyz,2030-09-02
7482,2987,4495,2001,9,3,xyz,2030-09-03
7392,4276,3116,2001,9,4,xyz,2030-09-04
5011,1437,3574,2001,9,5,xyz,2030-09-05
4941,5392,-451,2001,9,6,xyz,2030-09-06
7897,5398,2499,2001,9,7,xyz,2030-09-07
4860,2354,2506,2001,9,8,xyz,2030-09-08
5398,3600,1798,2001,9,9,xyz,2030-09-09
3835,753,3082,2001,9,10,xyz,2030-09-10
3061,9473,-6412,2001,9,11,xyz,2030-09-11
9735,1603,8132,2001,9,12,xyz,2030-09-12
7558,1953,5605,2001,9,13,xyz,2030-09-13
8767,7278,1489,2001,9,14,xyz,2030-09-14
4411,3063,1348,2001,9,15,xyz,2030-09-15
3389,3378,11,2001,9,16,xyz,2030-09-16
3803,1485,2318,2001,9,17,xyz,2030-09-17
2010,9258,-7248,2001,9,18,xyz,2030-09-18
8877,8037,840,2001,9,19,xyz,2030-09-19
8373,2110,6263,2001,9,20,xyz,2030-09-20
5932,4088,1844,2001,9,21,xyz,2030-09-21
7485,4648,2837,2001,9,22,xyz,2030-09-22
3924,6939,-3015,2001,9,23,xyz,2030-09-23
3330,9031,-5701,2001,9,24,xyz,2030-09-24
8376,3262,5114,2001,9,25,xyz,2030-09-25
7538,4726,2812,2001,9,26,xyz,2030-09-26
1064,2039,-975,2001,9,27,xyz,2030-09-27
4488,2129,2359,2001,9,28,xyz,2030-09-28
8829,3340,5489,2001,9,29,xyz,2030-09-29
1777,4687,-2910,2001,9,30,xyz,2030-09-30
5105,4409,696,2001,10,1,xyz,2030-10-01
2557,7143,-4586,2001,10,2,xyz,2030-10-02
3673,798,2875,2001,10,3,xyz,2030-10-03
8240,3581,4659,2001,10,4,xyz,2030-10-04
4156,8127,-3971,2001,10,5,xyz,2030-10-05
6135,4222,1913,2001,10,6,xyz,2030-10-06
5455,9285,-3830,2001,10,7,xyz,2030-10-07
7165,7508,-343,2001,10,8,xyz,2030-10-08
1783,6097,-4314,2001,10,9,xyz,2030-10-09
4316,5001,-685,2001,10,10,xyz,2030-10-10
7278,5701,1577,2001,10,11,xyz,2030-10-11
5838,8334,-2496,2001,10,12,xyz,2030-10-12
9581,5006,4575,2001,10,13,xyz,2030-10-13
4822,1190,3632,2001,10,14,xyz,2030-10-14
8691,8442,249,2001,10,15,xyz,2030-10-15
5620,3239,2381,2001,10,16,xyz,2030-10-16
5842,8330,-2488,2001,10,17,xyz,2030-10-17
8150,5271,2879,2001,10,18,xyz,2030-10-18
2302,6304,-4002,2001,10,19,xyz,2030-10-19
5299,9477,-4178,2001,10,20,xyz,2030-10-20
4884,4301,583,2001,10,21,xyz,2030-10-21
9271,9646,-375,2001,10,22,xyz,2030-10-22
2710,5969,-3259,2001,10,23,xyz,2030-10-23
6762,4649,2113,2001,10,24,xyz,2030-10-24
9362,2094,7268,2001,10,25,xyz,2030-10-25
4677,6715,-2038,2001,10,26,xyz,2030-10-26
5797,8078,-2281,2001,10,27,xyz,2030-10-27
8523,9328,-805,2001,10,28,xyz,2030-10-28
7656,6977,679,2001,10,29,xyz,2030-10-29
8659,4699,3960,2001,10,30,xyz,2030-10-30
5056,7371,-2315,2001,10,31,xyz,2030-10-31
4661,5792,-1131,2001,11,1,xyz,2030-11-01
1011,2966,-1955,2001,11,2,xyz,2030-11-02
2971,3252,-281,2001,11,3,xyz,2030-11-03
2242,4852,-2610,2001,11,4,xyz,2030-11-04
7265,4749,2516,2001,11,5,xyz,2030-11-05
3551,1453,2098,2001,11,6,xyz,2030-11-06
4430,8230,-3800,2001,11,7,xyz,2030-11-07
2805,1580,1225,2001,11,8,xyz,2030-11-08
2868,5263,-2395,2001,11,9,xyz,2030-11-09
8505,1582,6923,2001,11,10,xyz,2030-11-10
4184,2677,1507,2001,11,11,xyz,2030-11-11
8076,4456,3620,2001,11,12,xyz,2030-11-12
6213,4473,1740,2001,11,13,xyz,2030-11-13
1723,1239,484,2001,11,14,xyz,2030-11-14
8418,8973,-555,2001,11,15,xyz,2030-11-15
5707,2509,3198,2001,11,16,xyz,2030-11-16
6725,8655,-1930,2001,11,17,xyz,2030-11-17
9294,7464,1830,2001,11,18,xyz,2030-11-18
9479,3284,6195,2001,11,19,xyz,2030-11-19
1962,6509,-4547,2001,11,20,xyz,2030-11-20
1661,8819,-7158,2001,11,21,xyz,2030-11-21
3740,8986,-5246,2001,11,22,xyz,2030-11-22
2831,3325,-494,2001,11,23,xyz,2030-11-23
1930,8033,-6103,2001,11,24,xyz,2030-11-24
6012,8495,-2483,2001,11,25,xyz,2030-11-25
4655,1289,3366,2001,11,26,xyz,2030-11-26
5241,9294,-4053,2001,11,27,xyz,2030-11-27
1168,5778,-4610,2001,11,28,xyz,2030-11-28
1713,4959,-3246,2001,11,29,xyz,2030-11-29
7428,7928,-500,2001,11,30,xyz,2030-11-30
1623,1893,-270,2001,12,1,xyz,2030-12-01
4081,5400,-1319,2001,12,2,xyz,2030-12-02
3331,5860,-2529,2001,12,3,xyz,2030-12-03
3387,7615,-4228,2001,12,4,xyz,2030-12-04
1116,5307,-4191,2001,12,5,xyz,2030-12-05
3828,6664,-2836,2001,12,6,xyz,2030-12-06
8058,1948,6110,2001,12,7,xyz,2030-12-07
8256,4123,4133,2001,12,8,xyz,2030-12-08
7312,7612,-300,2001,12,9,xyz,2030-12-09
7623,9979,-2356,2001,12,10,xyz,2030-12-10
8823,1543,7280,2001,12,11,xyz,2030-12-11
7559,9995,-2436,2001,12,12,xyz,2030-12-12
9996,2972,7024,2001,12,13,xyz,2030-12-13
5532,8116,-2584,2001,12,14,xyz,2030-12-14
4480,3219,1261,2001,12,15,xyz,2030-12-15
7365,7490,-125,2001,12,16,xyz,2030-12-16
5192,4450,742,2001,12,17,xyz,2030-12-17
8199,2604,5595,2001,12,18,xyz,2030-12-18
2290,4885,-2595,2001,12,19,xyz,2030-12-19
6804,5604,1200,2001,12,20,xyz,2030-12-20
1189,613,576,2001,12,21,xyz,2030-12-21
4093,4536,-443,2001,12,22,xyz,2030-12-22
7224,802,6422,2001,12,23,xyz,2030-12-23
9452,1132,8320,2001,12,24,xyz,2030-12-24
9578,4386,5192,2001,12,25,xyz,2030-12-25
9283,4772,4511,2001,12,26,xyz,2030-12-26
8376,4575,3801,2001,12,27,xyz,2030-12-27
6035,2973,3062,2001,12,28,xyz,2030-12-28
5901,9500,-3599,2001,12,29,xyz,2030-12-29
2791,5207,-2416,2001,12,30,xyz,2030-12-30
9864,8007,1857,2001,12,31,xyz,2030-12-31
7932,7228,704,2002,1,1,xyz,2031-01-01
9060,5745,3315,2002,1,2,xyz,2031-01-02
8301,6978,1323,2002,1,3,xyz,2031-01-03
4301,9446,-5145,2002,1,4,xyz,2031-01-04
5919,6706,-787,2002,1,5,xyz,2031-01-05
2884,2334,550,2002,1,6,xyz,2031-01-06
8973,3351,5622,2002,1,7,xyz,2031-01-07
7750,2402,5348,2002,1,8,xyz,2031-01-08
4556,8865,-4309,2002,1,9,xyz,2031-01-09
9322,9902,-580,2002,1,10,xyz,2031-01-10
9638,4930,4708,2002,1,11,xyz,2031-01-11
8710,4547,4163,2002,1,12,xyz,2031-01-12
8319,1128,7191,2002,1,13,xyz,2031-01-13
8094,5707,2387,2002,1,14,xyz,2031-01-14
5792,9237,-3445,2002,1,15,xyz,2031-01-15
6476,7404,-928,2002,1,16,xyz,2031-01-16
3464,8781,-5317,2002,1,17,xyz,2031-01-17
1695,7821,-6126,2002,1,18,xyz,2031-01-18
4683,7021,-2338,2002,1,19,xyz,2031-01-19
1864,2880,-1016,2002,1,20,xyz,2031-01-20
8054,8011,43,2002,1,21,xyz,2031-01-21
5040,4009,1031,2002,1,22,xyz,2031-01-22
6373,9284,-2911,2002,1,23,xyz,2031-01-23
8497,9398,-901,2002,1,24,xyz,2031-01-24
7533,3969,3564,2002,1,25,xyz,2031-01-25
5068,2063,3005,2002,1,26,xyz,2031-01-26
2915,2617,298,2002,1,27,xyz,2031-01-27
8809,1960,6849,2002,1,28,xyz,2031-01-28
8778,2946,5832,2002,1,29,xyz,2031-01-29
5731,6841,-1110,2002,1,30,xyz,2031-01-30
8323,5299,3024,2002,1,31,xyz,2031-01-31
5899,578,5321,2002,2,1,xyz,2031-02-01
7569,8333,-764,2002,2,2,xyz,2031-02-02
5185,6441,-1256,2002,2,3,xyz,2031-02-03
4518,5895,-1377,2002,2,4,xyz,2031-02-04
8335,5021,3314,2002,2,5,xyz,2031-02-05
7426,9763,-2337,2002,2,6,xyz,2031-02-06
1712,733,979,2002,2,7,xyz,2031-02-07
4709,6294,-1585,2002,2,8,xyz,2031-02-08
4093,4627,-534,2002,2,9,xyz,2031-02-09
7603,6923,680,2002,2,10,xyz,2031-02-10
6165,7797,-1632,2002,2,11,xyz,2031-02-11
2757,688,2069,2002,2,12,xyz,2031-02-12
4974,6516,-1542,2002,2,13,xyz,2031-02-13
7876,6915,961,2002,2,14,xyz,2031-02-14
7768,1805,5963,2002,2,15,xyz,2031-02-15
8090,1943,6147,2002,2,16,xyz,2031-02-16
3357,8318,-4961,2002,2,17,xyz,2031-02-17
2695,8609,-5914,2002,2,18,xyz,2031-02-18
1749,4975,-3226,2002,2,19,xyz,2031-02-19
8106,4955,3151,2002,2,20,xyz,2031-02-20
8081,4262,3819,2002,2,21,xyz,2031-02-21
3835,9042,-5207,2002,2,22,xyz,2031-02-22
1848,5432,-3584,2002,2,23,xyz,2031-02-23
5970,1578,4392,2002,2,24,xyz,2031-02-24
1652,1648,4,2002,2,25,xyz,2031-02-25
9167,4202,4965,2002,2,26,xyz,2031-02-26
3821,9791,-5970,2002,2,27,xyz,2031-02-27
9899,4655,5244,2002,2,28,xyz,2031-02-28
9733,5507,4226,2002,3,1,xyz,2031-03-01
4603,4643,-40,2002,3,2,xyz,2031-03-02
7818,1408,6410,2002,3,3,xyz,2031-03-03
6065,2208,3857,2002,3,4,xyz,2031-03-04
8152,705,7447,2002,3,5,xyz,2031-03-05
3713,9688,-5975,2002,3,6,xyz,2031-03-06
4088,9440,-5352,2002,3,7,xyz,2031-03-07
7508,7197,311,2002,3,8,xyz,2031-03-08
2275,2482,-207,2002,3,9,xyz,2031-03-09
2432,8826,-6394,2002,3,10,xyz,2031-03-10
5876,5249,627,2002,3,11,xyz,2031-03-11
4861,6005,-1144,2002,3,12,xyz,2031-03-12
9510,8941,569,2002,3,13,xyz,2031-03-13
7916,4121,3795,2002,3,14,xyz,2031-03-14
6974,2421,4553,2002,3,15,xyz,2031-03-15
5321,7971,-2650,2002,3,16,xyz,2031-03-16
1174,971,203,2002,3,17,xyz,2031-03-17
7201,6097,1104,2002,3,18,xyz,2031-03-18
5651,1465,4186,2002,3,19,xyz,2031-03-19
1631,5028,-3397,2002,3,20,xyz,2031-03-20
3641,9195,-5554,2002,3,21,xyz,2031-03-21
6465,5153,1312,2002,3,22,xyz,2031-03-22
6109,539,5570,2002,3,23,xyz,2031-03-23
2414,6461,-4047,2002,3,24,xyz,2031-03-24
2419,6305,-3886,2002,3,25,xyz,2031-03-25
3573,3758,-185,2002,3,26,xyz,2031-03-26
7982,5818,2164,2002,3,27,xyz,2031-03-27
4483,8039,-3556,2002,3,28,xyz,2031-03-28
6295,1630,4665,2002,3,29,xyz,2031-03-29
8570,3562,5008,2002,3,30,xyz,2031-03-30
8860,9590,-730,2002,3,31,xyz,2031-03-31
4649,9098,-4449,2002,4,1,xyz,2031-04-01
7873,4015,3858,2002,4,2,xyz,2031-04-02
7243,8148,-905,2002,4,3,xyz,2031-04-03
6334,7773,-1439,2002,4,4,xyz,2031-04-04
1896,8313,-6417,2002,4,5,xyz,2031-04-05
1496,7000,-5504,2002,4,6,xyz,2031-04-06
4592,8084,-3492,2002,4,7,xyz,2031-04-07
5767,2500,3267,2002,4,8,xyz,2031-04-08
2340,4200,-1860,2002,4,9,xyz,2031-04-09
8496,7294,1202,2002,4,10,xyz,2031-04-10
9426,1572,7854,2002,4,11,xyz,2031-04-11
2851,5359,-2508,2002,4,12,xyz,2031-04-12
9742,2747,6995,2002,4,13,xyz,2031-04-13
3643,1475,2168,2002,4,14,xyz,2031-04-14
4730,9785,-5055,2002,4,15,xyz,2031-04-15
3131,2094,1037,2002,4,16,xyz,2031-04-16
7905,7471,434,2002,4,17,xyz,2031-04-17
4812,2207,2605,2002,4,18,xyz,2031-04-18
8356,5958,2398,2002,4,19,xyz,2031-04-19
1225,8589,-7364,2002,4,20,xyz,2031-04-20
2826,6698,-3872,2002,4,21,xyz,2031-04-21
2724,6395,-3671,2002,4,22,xyz,2031-04-22
4830,1725,3105,2002,4,23,xyz,2031-04-23
5906,5467,439,2002,4,24,xyz,2031-04-24
3150,667,2483,2002,4,25,xyz,2031-04-25
6014,4283,1731,2002,4,26,xyz,2031-04-26
2548,1853,695,2002,4,27,xyz,2031-04-27
7144,8676,-1532,2002,4,28,xyz,2031-04-28
3354,4122,-768,2002,4,29,xyz,2031-04-29
1389,2369,-980,2002,4,30,xyz,2031-04-30
3086,5142,-2056,2002,5,1,xyz,2031-05-01
7695,4424,3271,2002,5,2,xyz,2031-05-02
6725,6834,-109,2002,5,3,xyz,2031-05-03
8676,7428,1248,2002,5,4,xyz,2031-05-04
8372,1726,6646,2002,5,5,xyz,2031-05-05
1698,2557,-859,2002,5,6,xyz,2031-05-06
2882,8959,-6077,2002,5,7,xyz,2031-05-07
6656,4527,2129,2002,5,8,xyz,2031-05-08
4278,5872,-1594,2002,5,9,xyz,2031-05-09
9768,5394,4374,2002,5,10,xyz,2031-05-10
2582,7747,-5165,2002,5,11,xyz,2031-05-11
2248,2065,183,2002,5,12,xyz,2031-05-12
4998,2297,2701,2002,5,13,xyz,2031-05-13
2001,8433,-6432,2002,5,14,xyz,2031-05-14
1851,4325,-2474,2002,5,15,xyz,2031-05-15
9530,3821,5709,2002,5,16,xyz,2031-05-16
5771,5624,147,2002,5,17,xyz,2031-05-17
3885,3740,145,2002,5,18,xyz,2031-05-18
6290,3035,3255,2002,5,19,xyz,2031-05-19
1024,2066,-1042,2002,5,20,xyz,2031-05-20
4813,6777,-1964,2002,5,21,xyz,2031-05-21
1974,5350,-3376,2002,5,22,xyz,2031-05-22
8872,9984,-1112,2002,5,23,xyz,2031-05-23
7349,2353,4996,2002,5,24,xyz,2031-05-24
8367,7810,557,2002,5,25,xyz,2031-05-25
6472,4568,1904,2002,5,26,xyz,2031-05-26
2085,4921,-2836,2002,5,27,xyz,2031-05-27
8099,5166,2933,2002,5,28,xyz,2031-05-28
6724,8149,-1425,2002,5,29,xyz,2031-05-29
1838,8998,-7160,2002,5,30,xyz,2031-05-30
2103,1521,582,2002,5,31,xyz,2031-05-31
3226,4895,-1669,2002,6,1,xyz,2031-06-01
4127,7104,-2977,2002,6,2,xyz,2031-06-02
1937,7354,-5417,2002,6,3,xyz,2031-06-03
7877,5773,2104,2002,6,4,xyz,2031-06-04
9512,2061,7451,2002,6,5,xyz,2031-06-05
3901,8960,-5059,2002,6,6,xyz,2031-06-06
6104,9430,-3326,2002,6,7,xyz,2031-06-07
5081,9983,-4902,2002,6,8,xyz,2031-06-08
8412,3090,5322,2002,6,9,xyz,2031-06-09
1842,9087,-7245,2002,6,10,xyz,2031-06-10
7879,7339,540,2002,6,11,xyz,2031-06-11
4053,7865,-3812,2002,6,12,xyz,2031-06-12
4224,4903,-679,2002,6,13,xyz,2031-06-13
1985,4424,-2439,2002,6,14,xyz,2031-06-14
2604,5936,-3332,2002,6,15,xyz,2031-06-15
8913,2969,5944,2002,6,16,xyz,2031-06-16
2806,8383,-5577,2002,6,17,xyz,2031-06-17
8026,8129,-103,2002,6,18,xyz,2031-06-18
3430,1897,1533,2002,6,19,xyz,2031-06-19
1707,5144,-3437,2002,6,20,xyz,2031-06-20
2680,5889,-3209,2002,6,21,xyz,2031-06-21
8763,1631,7132,2002,6,22,xyz,2031-06-22
9976,2433,7543,2002,6,23,xyz,2031-06-23
1579,7188,-5609,2002,6,24,xyz,2031-06-24
6745,5724,1021,2002,6,25,xyz,2031-06-25
3279,8327,-5048,2002,6,26,xyz,2031-06-26
8449,3305,5144,2002,6,27,xyz,2031-06-27
4231,9620,-5389,2002,6,28,xyz,2031-06-28
5903,904,4999,2002,6,29,xyz,2031-06-29
1844,3059,-1215,2002,6,30,xyz,2031-06-30
7666,8254,-588,2002,7,1,xyz,2031-07-01
1553,7672,-6119,2002,7,2,xyz,2031-07-02
2684,4143,-1459,2002,7,3,xyz,2031-07-03
9983,6442,3541,2002,7,4,xyz,2031-07-04
2632,2436,196,2002,7,5,xyz,2031-07-05
2162,2030,132,2002,7,6,xyz,2031-07-06
2073,6471,-4398,2002,7,7,xyz,2031-07-07
6692,4963,1729,2002,7,8,xyz,2031-07-08
8597,6212,2385,2002,7,9,xyz,2031-07-09
4328,508,3820,2002,7,10,xyz,2031-07-10
9621,5158,4463,2002,7,11,xyz,2031-07-11
4407,2538,1869,2002,7,12,xyz,2031-07-12
1303,1611,-308,2002,7,13,xyz,2031-07-13
1816,4166,-2350,2002,7,14,xyz,2031-07-14
4816,9631,-4815,2002,7,15,xyz,2031-07-15
7812,4559,3253,2002,7,16,xyz,2031-07-16
3063,887,2176,2002,7,17,xyz,2031-07-17
4978,8654,-3676,2002,7,18,xyz,2031-07-18
2488,6887,-4399,2002,7,19,xyz,2031-07-19
2078,2086,-8,2002,7,20,xyz,2031-07-20
3075,8102,-5027,2002,7,21,xyz,2031-07-21
3220,9019,-5799,2002,7,22,xyz,2031-07-22
3190,3123,67,2002,7,23,xyz,2031-07-23
7407,888,6519,2002,7,24,xyz,2031-07-24
9611,8126,1485,2002,7,25,xyz,2031-07-25
7363,1330,6033,2002,7,26,xyz,2031-07-26
1188,5951,-4763,2002,7,27,xyz,2031-07-27
9689,4635,5054,2002,7,28,xyz,2031-07-28
1225,8204,-6979,2002,7,29,xyz,2031-07-29
3245,8650,-5405,2002,7,30,xyz,2031-07-30
8240,2030,6210,2002,7,31,xyz,2031-07-31
6303,2791,3512,2002,8,1,xyz,2031-08-01
5521,9480,-3959,2002,8,2,xyz,2031-08-02
2484,2120,364,2002,8,3,xyz,2031-08-03
1738,9122,-7384,2002,8,4,xyz,2031-08-04
4397,5881,-1484,2002,8,5,xyz,2031-08-05
9322,1408,7914,2002,8,6,xyz,2031-08-06
1070,4760,-3690,2002,8,7,xyz,2031-08-07
5034,3313,1721,2002,8,8,xyz,2031-08-08
4186,6885,-2699,2002,8,9,xyz,2031-08-09
6204,5083,1121,2002,8,10,xyz,2031-08-10
8796,5716,3080,2002,8,11,xyz,2031-08-11
3892,543,3349,2002,8,12,xyz,2031-08-12
9292,859,8433,2002,8,13,xyz,2031-08-13
6264,7892,-1628,2002,8,14,xyz,2031-08-14
4131,9244,-5113,2002,8,15,xyz,2031-08-15
4132,5689,-1557,2002,8,16,xyz,2031-08-16
5426,9708,-4282,2002,8,17,xyz,2031-08-17
9070,7057,2013,2002,8,18,xyz,2031-08-18
4663,9201,-4538,2002,8,19,xyz,2031-08-19
3800,8860,-5060,2002,8,20,xyz,2031-08-20
4981,5084,-103,2002,8,21,xyz,2031-08-21
9838,9862,-24,2002,8,22,xyz,2031-08-22
4028,522,3506,2002,8,23,xyz,2031-08-23
1075,4064,-2989,2002,8,24,xyz,2031-08-24
8951,856,8095,2002,8,25,xyz,2031-08-25
1642,4893,-3251,2002,8,26,xyz,2031-08-26
5802,8219,-2417,2002,8,27,xyz,2031-08-27
5556,4731,825,2002,8,28,xyz,2031-08-28
8847,7688,1159,2002,8,29,xyz,2031-08-29
5356,6044,-688,2002,8,30,xyz,2031-08-30
8148,7748,400,2002,8,31,xyz,2031-08-31
8878,5672,3206,2002,9,1,xyz,2031-09-01
4045,4750,-705,2002,9,2,xyz,2031-09-02
2975,5804,-2829,2002,9,3,xyz,2031-09-03
2019,9587,-7568,2002,9,4,xyz,2031-09-04
6639,6989,-350,2002,9,5,xyz,2031-09-05
3654,7056,-3402,2002,9,6,xyz,2031-09-06
7384,7029,355,2002,9,7,xyz,2031-09-07
3983,1155,2828,2002,9,8,xyz,2031-09-08
5721,8933,-3212,2002,9,9,xyz,2031-09-09
8544,5427,3117,2002,9,10,xyz,2031-09-10
2490,7639,-5149,2002,9,11,xyz,2031-09-11
8785,4836,3949,2002,9,12,xyz,2031-09-12
8295,7501,794,2002,9,13,xyz,2031-09-13
8338,9225,-887,2002,9,14,xyz,2031-09-14
1770,2315,-545,2002,9,15,xyz,2031-09-15
8557,5767,2790,2002,9,16,xyz,2031-09-16
7724,6913,811,2002,9,17,xyz,2031-09-17
8618,1760,6858,2002,9,18,xyz,2031-09-18
9654,5266,4388,2002,9,19,xyz,2031-09-19
4643,8676,-4033,2002,9,20,xyz,2031-09-20
7935,4281,3654,2002,9,21,xyz,2031-09-21
1403,2945,-1542,2002,9,22,xyz,2031-09-22
1319,5077,-3758,2002,9,23,xyz,2031-09-23
6806,7786,-980,2002,9,24,xyz,2031-09-24
5163,7426,-2263,2002,9,25,xyz,2031-09-25
1607,6685,-5078,2002,9,26,xyz,2031-09-26
4721,9477,-4756,2002,9,27,xyz,2031-09-27
4904,2268,2636,2002,9,28,xyz,2031-09-28
5118,1452,3666,2002,9,29,xyz,2031-09-29
2780,625,2155,2002,9,30,xyz,2031-09-30
9953,9334,619,2002,10,1,xyz,2031-10-01
5626,1132,4494,2002,10,2,xyz,2031-10-02
3625,9706,-6081,2002,10,3,xyz,2031-10-03
2291,1601,690,2002,10,4,xyz,2031-10-04
1757,2144,-387,2002,10,5,xyz,2031-10-05
8160,6048,2112,2002,10,6,xyz,2031-10-06
7951,9108,-1157,2002,10,7,xyz,2031-10-07
7376,6728,648,2002,10,8,xyz,2031-10-08
5673,1275,4398,2002,10,9,xyz,2031-10-09
1934,6320,-4386,2002,10,10,xyz,2031-10-10
6550,6253,297,2002,10,11,xyz,2031-10-11
1595,8576,-6981,2002,10,12,xyz,2031-10-12
2450,2087,363,2002,10,13,xyz,2031-10-13
2095,7563,-5468,2002,10,14,xyz,2031-10-14
3928,8803,-4875,2002,10,15,xyz,2031-10-15
5530,6359,-829,2002,10,16,xyz,2031-10-16
8873,2208,6665,2002,10,17,xyz,2031-10-17
8553,9191,-638,2002,10,18,xyz,2031-10-18
6319,7798,-1479,2002,10,19,xyz,2031-10-19
6673,4468,2205,2002,10,20,xyz,2031-10-20
8419,6117,2302,2002,10,21,xyz,2031-10-21
7343,7629,-286,2002,10,22,xyz,2031-10-22
3953,7413,-3460,2002,10,23,xyz,2031-10-23
6358,1472,4886,2002,10,24,xyz,2031-10-24
3354,7241,-3887,2002,10,25,xyz,2031-10-25
3914,9992,-6078,2002,10,26,xyz,2031-10-26
2323,5628,-3305,2002,10,27,xyz,2031-10-27
6151,3891,2260,2002,10,28,xyz,2031-10-28
2639,4076,-1437,2002,10,29,xyz,2031-10-29
6187,4168,2019,2002,10,30,xyz,2031-10-30
9084,1732,7352,2002,10,31,xyz,2031-10-31
3991,2847,1144,2002,11,1,xyz,2031-11-01
4020,8550,-4530,2002,11,2,xyz,2031-11-02
1736,9145,-7409,2002,11,3,xyz,2031-11-03
6258,7618,-1360,2002,11,4,xyz,2031-11-04
2936,4687,-1751,2002,11,5,xyz,2031-11-05
4417,1539,2878,2002,11,6,xyz,2031-11-06
9516,4263,5253,2002,11,7,xyz,2031-11-07
3963,2369,1594,2002,11,8,xyz,2031-11-08
7344,6627,717,2002,11,9,xyz,2031-11-09
4940,4699,241,2002,11,10,xyz,2031-11-10
6202,1759,4443,2002,11,11,xyz,2031-11-11
8795,1700,7095,2002,11,12,xyz,2031-11-12
5742,3553,2189,2002,11,13,xyz,2031-11-13
8621,9698,-1077,2002,11,14,xyz,2031-11-14
3847,5927,-2080,2002,11,15,xyz,2031-11-15
7789,7249,540,2002,11,16,xyz,2031-11-16
9418,1883,7535,2002,11,17,xyz,2031-11-17
8000,8079,-79,2002,11,18,xyz,2031-11-18
7854,2833,5021,2002,11,19,xyz,2031-11-19
2244,3617,-1373,2002,11,20,xyz,2031-11-20
6234,5152,1082,2002,11,21,xyz,2031-11-21
4439,4436,3,2002,11,22,xyz,2031-11-22
1086,3355,-2269,2002,11,23,xyz,2031-11-23
6184,6845,-661,2002,11,24,xyz,2031-11-24
4558,2625,1933,2002,11,25,xyz,2031-11-25
2812,9078,-6266,2002,11,26,xyz,2031-11-26
6959,2552,4407,2002,11,27,xyz,2031-11-27
7090,933,6157,2002,11,28,xyz,2031-11-28
5571,4764,807,2002,11,29,xyz,2031-11-29
7221,8376,-1155,2002,11,30,xyz,2031-11-30
5871,8205,-2334,2002,12,1,xyz,2031-12-01
5334,576,4758,2002,12,2,xyz,2031-12-02
9135,6615,2520,2002,12,3,xyz,2031-12-03
2050,8888,-6838,2002,12,4,xyz,2031-12-04
7555,8403,-848,2002,12,5,xyz,2031-12-05
9718,1170,8548,2002,12,6,xyz,2031-12-06
8995,9216,-221,2002,12,7,xyz,2031-12-07
8508,2645,5863,2002,12,8,xyz,2031-12-08
2710,1744,966,2002,12,9,xyz,2031-12-09
2339,5836,-3497,2002,12,10,xyz,2031-12-10
1344,7179,-5835,2002,12,11,xyz,2031-12-11
5294,5760,-466,2002,12,12,xyz,2031-12-12
8796,8564,232,2002,12,13,xyz,2031-12-13
5328,9297,-3969,2002,12,14,xyz,2031-12-14
9472,6216,3256,2002,12,15,xyz,2031-12-15
2943,9130,-6187,2002,12,16,xyz,2031-12-16
1077,4727,-3650,2002,12,17,xyz,2031-12-17
9482,2810,6672,2002,12,18,xyz,2031-12-18
8595,5022,3573,2002,12,19,xyz,2031-12-19
9064,7565,1499,2002,12,20,xyz,2031-12-20
8241,1360,6881,2002,12,21,xyz,2031-12-21
7121,3172,3949,2002,12,22,xyz,2031-12-22
6173,8872,-2699,2002,12,23,xyz,2031-12-23
4062,7262,-3200,2002,12,24,xyz,2031-12-24
2896,2053,843,2002,12,25,xyz,2031-12-25
4857,4060,797,2002,12,26,xyz,2031-12-26
4704,7499,-2795,2002,12,27,xyz,2031-12-27
7310,4566,2744,2002,12,28,xyz,2031-12-28
8075,8262,-187,2002,12,29,xyz,2031-12-29
3378,3296,82,2002,12,30,xyz,2031-12-30
2784,3182,-398,2002,12,31,xyz,2031-12-31
9628,4626,5002,2003,1,1,xyz,2032-01-01
8514,8588,-74,2003,1,2,xyz,2032-01-02
8666,8199,467,2003,1,3,xyz,2032-01-03
7222,9430,-2208,2003,1,4,xyz,2032-01-04
6676,7031,-355,2003,1,5,xyz,2032-01-05
1616,8701,-7085,2003,1,6,xyz,2032-01-06
4037,3060,977,2003,1,7,xyz,2032-01-07
9455,845,8610,2003,1,8,xyz,2032-01-08
4230,4614,-384,2003,1,9,xyz,2032-01-09
6227,6182,45,2003,1,10,xyz,2032-01-10
7132,3685,3447,2003,1,11,xyz,2032-01-11
4999,1041,3958,2003,1,12,xyz,2032-01-12
5672,3968,1704,2003,1,13,xyz,2032-01-13
5832,9384,-3552,2003,1,14,xyz,2032-01-14
7685,8650,-965,2003,1,15,xyz,2032-01-15
6468,8485,-2017,2003,1,16,xyz,2032-01-16
5045,9318,-4273,2003,1,17,xyz,2032-01-17
5150,3566,1584,2003,1,18,xyz,2032-01-18
9782,9248,534,2003,1,19,xyz,2032-01-19
8696,1937,6759,2003,1,20,xyz,2032-01-20
6459,6837,-378,2003,1,21,xyz,2032-01-21
1297,2652,-1355,2003,1,22,xyz,2032-01-22
2371,7099,-4728,2003,1,23,xyz,2032-01-23
9375,2278,7097,2003,1,24,xyz,2032-01-24
5952,3671,2281,2003,1,25,xyz,2032-01-25
7862,1372,6490,2003,1,26,xyz,2032-01-26
5188,6006,-818,2003,1,27,xyz,2032-01-27
6014,4149,1865,2003,1,28,xyz,2032-01-28
4024,9083,-5059,2003,1,29,xyz,2032-01-29
9584,2085,7499,2003,1,30,xyz,2032-01-30
4655,2100,2555,2003,1,31,xyz,2032-01-31
7857,6061,1796,2003,2,1,xyz,2032-02-01
6096,4023,2073,2003,2,2,xyz,2032-02-02
1904,7075,-5171,2003,2,3,xyz,2032-02-03
2756,3301,-545,2003,2,4,xyz,2032-02-04
9110,9725,-615,2003,2,5,xyz,2032-02-05
8213,2302,5911,2003,2,6,xyz,2032-02-06
6784,7557,-773,2003,2,7,xyz,2032-02-07
2604,8188,-5584,2003,2,8,xyz,2032-02-08
1838,8897,-7059,2003,2,9,xyz,2032-02-09
9096,7021,2075,2003,2,10,xyz,2032-02-10
5527,8369,-2842,2003,2,11,xyz,2032-02-11
8959,4737,4222,2003,2,12,xyz,2032-02-12
3178,952,2226,2003,2,13,xyz,2032-02-13
8736,1571,7165,2003,2,14,xyz,2032-02-14
1298,3286,-1988,2003,2,15,xyz,2032-02-15
5446,1589,3857,2003,2,16,xyz,2032-02-16
2356,5449,-3093,2003,2,17,xyz,2032-02-17
1686,4110,-2424,2003,2,18,xyz,2032-02-18
6703,7737,-1034,2003,2,19,xyz,2032-02-19
1134,5573,-4439,2003,2,20,xyz,2032-02-20
4756,8221,-3465,2003,2,21,xyz,2032-02-21
8645,8100,545,2003,2,22,xyz,2032-02-22
5251,621,4630,2003,2,23,xyz,2032-02-23
6219,3639,2580,2003,2,24,xyz,2032-02-24
6011,9183,-3172,2003,2,25,xyz,2032-02-25
1040,2217,-1177,2003,2,26,xyz,2032-02-26
3236,750,2486,2003,2,27,xyz,2032-02-27
1425,4908,-3483,2003,2,28,xyz,2032-02-28
9770,1117,8653,2003,2,29,xyz,2032-02-29
4867,7753,-2886,2003,3,1,xyz,2032-03-01
3136,702,2434,2003,3,2,xyz,2032-03-02
5167,3686,1481,2003,3,3,xyz,2032-03-03
7188,1213,5975,2003,3,4,xyz,2032-03-04
2183,1093,1090,2003,3,5,xyz,2032-03-05
5397,6881,-1484,2003,3,6,xyz,2032-03-06
7146,1099,6047,2003,3,7,xyz,2032-03-07
8420,2526,5894,2003,3,8,xyz,2032-03-08
3907,8651,-4744,2003,3,9,xyz,2032-03-09
2420,7342,-4922,2003,3,10,xyz,2032-03-10
1230,5902,-4672,2003,3,11,xyz,2032-03-11
6905,7366,-461,2003,3,12,xyz,2032-03-12
6457,3337,3120,2003,3,13,xyz,2032-03-13
2513,7421,-4908,2003,3,14,xyz,2032-03-14
4722,8251,-3529,2003,3,15,xyz,2032-03-15
5316,5379,-63,2003,3,16,xyz,2032-03-16
2417,8228,-5811,2003,3,17,xyz,2032-03-17
5156,3631,1525,2003,3,18,xyz,2032-03-18
3186,8083,-4897,2003,3,19,xyz,2032-03-19
2920,4979,-2059,2003,3,20,xyz,2032-03-20
7874,8914,-1040,2003,3,21,xyz,2032-03-21
1443,4470,-3027,2003,3,22,xyz,2032-03-22
9396,1258,8138,2003,3,23,xyz,2032-03-23
7426,2595,4831,2003,3,24,xyz,2032-03-24
4565,6755,-2190,2003,3,25,xyz,2032-03-25
8727,3293,5434,2003,3,26,xyz,2032-03-26
9183,5146,4037,2003,3,27,xyz,2032-03-27
9228,4141,5087,2003,3,28,xyz,2032-03-28
9945,7721,2224,2003,3,29,xyz,2032-03-29
2246,3796,-1550,2003,3,30,xyz,2032-03-30
5057,3429,1628,2003,3,31,xyz,2032-03-31
9684,6370,3314,2003,4,1,xyz,2032-04-01
7343,3101,4242,2003,4,2,xyz,2032-04-02
3447,3047,400,2003,4,3,xyz,2032-04-03
6905,4828,2077,2003,4,4,xyz,2032-04-04
7401,4417,2984,2003,4,5,xyz,2032-04-05
3607,7685,-4078,2003,4,6,xyz,2032-04-06
5543,8803,-3260,2003,4,7,xyz,2032-04-07
3925,6399,-2474,2003,4,8,xyz,2032-04-08
9713,9377,336,2003,4,9,xyz,2032-04-09
4559,1587,2972,2003,4,10,xyz,2032-04-10
3252,4419,-1167,2003,4,11,xyz,2032-04-11
8535,9450,-915,2003,4,12,xyz,2032-04-12
7998,5834,2164,2003,4,13,xyz,2032-04-13
1749,8177,-6428,2003,4,14,xyz,2032-04-14
3463,9928,-6465,2003,4,15,xyz,2032-04-15
6404,4100,2304,2003,4,16,xyz,2032-04-16
7242,872,6370,2003,4,17,xyz,2032-04-17
8045,3019,5026,2003,4,18,xyz,2032-04-18
5038,5588,-550,2003,4,19,xyz,2032-04-19
7526,2713,4813,2003,4,20,xyz,2032-04-20
4419,3615,804,2003,4,21,xyz,2032-04-21
4778,1463,3315,2003,4,22,xyz,2032-04-22
3727,5288,-1561,2003,4,23,xyz,2032-04-23
8176,5358,2818,2003,4,24,xyz,2032-04-24
7007,8244,-1237,2003,4,25,xyz,2032-04-25
2067,2938,-871,2003,4,26,xyz,2032-04-26
3765,6443,-2678,2003,4,27,xyz,2032-04-27
7052,4688,2364,2003,4,28,xyz,2032-04-28
2287,2729,-442,2003,4,29,xyz,2032-04-29
5970,2536,3434,2003,4,30,xyz,2032-04-30
6140,8845,-2705,2003,5,1,xyz,2032-05-01
1386,8252,-6866,2003,5,2,xyz,2032-05-02
2060,2755,-695,2003,5,3,xyz,2032-05-03
4919,5096,-177,2003,5,4,xyz,2032-05-04
3821,1745,2076,2003,5,5,xyz,2032-05-05
1208,8990,-7782,2003,5,6,xyz,2032-05-06
2151,6196,-4045,2003,5,7,xyz,2032-05-07
1269,1492,-223,2003,5,8,xyz,2032-05-08
2126,6581,-4455,2003,5,9,xyz,2032-05-09
5811,7622,-1811,2003,5,10,xyz,2032-05-10
2039,2501,-462,2003,5,11,xyz,2032-05-11
2050,8339,-6289,2003,5,12,xyz,2032-05-12
5363,4281,1082,2003,5,13,xyz,2032-05-13
5235,6810,-1575,2003,5,14,xyz,2032-05-14
9696,4397,5299,2003,5,15,xyz,2032-05-15
4358,9942,-5584,2003,5,16,xyz,2032-05-16
1221,2368,-1147,2003,5,17,xyz,2032-05-17
7825,8460,-635,2003,5,18,xyz,2032-05-18
8771,1642,7129,2003,5,19,xyz,2032-05-19
7582,7799,-217,2003,5,20,xyz,2032-05-20
6281,1524,4757,2003,5,21,xyz,2032-05-21
2658,6974,-4316,2003,5,22,xyz,2032-05-22
2013,9891,-7878,2003,5,23,xyz,2032-05-23
6350,7344,-994,2003,5,24,xyz,2032-05-24
4148,7800,-3652,2003,5,25,xyz,2032-05-25
3443,6137,-2694,2003,5,26,xyz,2032-05-26
7798,4542,3256,2003,5,27,xyz,2032-05-27
6994,5900,1094,2003,5,28,xyz,2032-05-28
9063,1832,7231,2003,5,29,xyz,2032-05-29
7571,6953,618,2003,5,30,xyz,2032-05-30
4547,5235,-688,2003,5,31,xyz,2032-05-31
9350,3026,6324,2003,6,1,xyz,2032-06-01
9490,2552,6938,2003,6,2,xyz,2032-06-02
3862,7827,-3965,2003,6,3,xyz,2032-06-03
2588,6713,-4125,2003,6,4,xyz,2032-06-04
9140,8557,583,2003,6,5,xyz,2032-06-05
7733,6214,1519,2003,6,6,xyz,2032-06-06
4422,2646,1776,2003,6,7,xyz,2032-06-07
1682,8002,-6320,2003,6,8,xyz,2032-06-08
8610,723,7887,2003,6,9,xyz,2032-06-09
6208,5066,1142,2003,6,10,xyz,2032-06-10
5231,3440,1791,2003,6,11,xyz,2032-06-11
7214,3025,4189,2003,6,12,xyz,2032-06-12
9087,4821,4266,2003,6,13,xyz,2032-06-13
8050,7023,1027,2003,6,14,xyz,2032-06-14
4798,6008,-1210,2003,6,15,xyz,2032-06-15
4051,8575,-4524,2003,6,16,xyz,2032-06-16
6727,659,6068,2003,6,17,xyz,2032-06-17
7792,9759,-1967,2003,6,18,xyz,2032-06-18
8497,6241,2256,2003,6,19,xyz,2032-06-19
9392,2373,7019,2003,6,20,xyz,2032-06-20
1595,4276,-2681,2003,6,21,xyz,2032-06-21
2407,6687,-4280,2003,6,22,xyz,2032-06-22
7966,2049,5917,2003,6,23,xyz,2032-06-23
6399,8672,-2273,2003,6,24,xyz,2032-06-24
8429,7737,692,2003,6,25,xyz,2032-06-25
7303,1444,5859,2003,6,26,xyz,2032-06-26
8352,7957,395,2003,6,27,xyz,2032-06-27
8262,1613,6649,2003,6,28,xyz,2032-06-28
8449,9313,-864,2003,6,29,xyz,2032-06-29
4993,4506,487,2003,6,30,xyz,2032-06-30
8822,7037,1785,2003,7,1,xyz,2032-07-01
9003,1651,7352,2003,7,2,xyz,2032-07-02
9572,5763,3809,2003,7,3,xyz,2032-07-03
4240,7402,-3162,2003,7,4,xyz,2032-07-04
5579,1631,3948,2003,7,5,xyz,2032-07-05
8989,5724,3265,2003,7,6,xyz,2032-07-06
3623,8493,-4870,2003,7,7,xyz,2032-07-07
4786,5638,-852,2003,7,8,xyz,2032-07-08
1447,8936,-7489,2003,7,9,xyz,2032-07-09
9939,9998,-59,2003,7,10,xyz,2032-07-10
4534,1581,2953,2003,7,11,xyz,2032-07-11
6381,6197,184,2003,7,12,xyz,2032-07-12
2924,1882,1042,2003,7,13,xyz,2032-07-13
8427,9601,-1174,2003,7,14,xyz,2032-07-14
2001,2357,-356,2003,7,15,xyz,2032-07-15
9622,7267,2355,2003,7,16,xyz,2032-07-16
5945,4334,1611,2003,7,17,xyz,2032-07-17
9886,8368,1518,2003,7,18,xyz,2032-07-18
5862,8724,-2862,2003,7,19,xyz,2032-07-19
3154,6821,-3667,2003,7,20,xyz,2032-07-20
9658,2997,6661,2003,7,21,xyz,2032-07-21
2916,7322,-4406,2003,7,22,xyz,2032-07-22
6945,8185,-1240,2003,7,23,xyz,2032-07-23
1471,2492,-1021,2003,7,24,xyz,2032-07-24
2868,9758,-6890,2003,7,25,xyz,2032-07-25
7760,7820,-60,2003,7,26,xyz,2032-07-26
1786,1912,-126,2003,7,27,xyz,2032-07-27
4884,9240,-4356,2003,7,28,xyz,2032-07-28
7034,6839,195,2003,7,29,xyz,2032-07-29
6858,1460,5398,2003,7,30,xyz,2032-07-30
7134,2342,4792,2003,7,31,xyz,2032-07-31
6135,6312,-177,2003,8,1,xyz,2032-08-01
1903,1458,445,2003,8,2,xyz,2032-08-02
8330,8576,-246,2003,8,3,xyz,2032-08-03
9736,4219,5517,2003,8,4,xyz,2032-08-04
1369,7057,-5688,2003,8,5,xyz,2032-08-05
3981,6287,-2306,2003,8,6,xyz,2032-08-06
6410,7993,-1583,2003,8,7,xyz,2032-08-07
3322,9000,-5678,2003,8,8,xyz,2032-08-08
9363,8230,1133,2003,8,9,xyz,2032-08-09
6893,6732,161,2003,8,10,xyz,2032-08-10
4905,1970,2935,2003,8,11,xyz,2032-08-11
3606,1514,2092,2003,8,12,xyz,2032-08-12
6264,3415,2849,2003,8,13,xyz,2032-08-13
6082,7518,-1436,2003,8,14,xyz,2032-08-14
4148,4573,-425,2003,8,15,xyz,2032-08-15
3325,1526,1799,2003,8,16,xyz,2032-08-16
6872,519,6353,2003,8,17,xyz,2032-08-17
1792,3221,-1429,2003,8,18,xyz,2032-08-18
2388,5709,-3321,2003,8,19,xyz,2032-08-19
6915,2629,4286,2003,8,20,xyz,2032-08-20
6293,2810,3483,2003,8,21,xyz,2032-08-21
5059,7903,-2844,2003,8,22,xyz,2032-08-22
1349,9520,-8171,2003,8,23,xyz,2032-08-23
7401,3995,3406,2003,8,24,xyz,2032-08-24
4649,9131,-4482,2003,8,25,xyz,2032-08-25
1348,1199,149,2003,8,26,xyz,2032-08-26
6819,5095,1724,2003,8,27,xyz,2032-08-27
9054,2986,6068,2003,8,28,xyz,2032-08-28
3674,8265,-4591,2003,8,29,xyz,2032-08-29
6372,8741,-2369,2003,8,30,xyz,2032-08-30
7515,6164,1351,2003,8,31,xyz,2032-08-31
7200,7209,-9,2003,9,1,xyz,2032-09-01
4074,6974,-2900,2003,9,2,xyz,2032-09-02
4775,1712,3063,2003,9,3,xyz,2032-09-03
6941,789,6152,2003,9,4,xyz,2032-09-04
7274,7459,-185,2003,9,5,xyz,2032-09-05
5162,3703,1459,2003,9,6,xyz,2032-09-06
6023,9264,-3241,2003,9,7,xyz,2032-09-07
6698,1056,5642,2003,9,8,xyz,2032-09-08
6922,9729,-2807,2003,9,9,xyz,2032-09-09
1375,9953,-8578,2003,9,10,xyz,2032-09-10
5759,742,5017,2003,9,11,xyz,2032-09-11
3775,6520,-2745,2003,9,12,xyz,2032-09-12
8550,4646,3904,2003,9,13,xyz,2032-09-13
2605,1843,762,2003,9,14,xyz,2032-09-14
2423,3729,-1306,2003,9,15,xyz,2032-09-15
6758,2802,3956,2003,9,16,xyz,2032-09-16
1879,6590,-4711,2003,9,17,xyz,2032-09-17
4741,2373,2368,2003,9,18,xyz,2032-09-18
3459,3882,-423,2003,9,19,xyz,2032-09-19
2843,8245,-5402,2003,9,20,xyz,2032-09-20
9142,4900,4242,2003,9,21,xyz,2032-09-21
1445,2175,-730,2003,9,22,xyz,2032-09-22
6441,4674,1767,2003,9,23,xyz,2032-09-23
2878,7864,-4986,2003,9,24,xyz,2032-09-24
3928,7238,-3310,2003,9,25,xyz,2032-09-25
1377,7632,-6255,2003,9,26,xyz,2032-09-26
1697,3771,-2074,2003,9,27,xyz,2032-09-27
6310,8288,-1978,2003,9,28,xyz,2032-09-28
1968,1720,248,2003,9,29,xyz,2032-09-29
8361,5910,2451,2003,9,30,xyz,2032-09-30
4127,3064,1063,2003,10,1,xyz,2032-10-01
7953,8034,-81,2003,10,2,xyz,2032-10-02
2638,2201,437,2003,10,3,xyz,2032-10-03
3945,8098,-4153,2003,10,4,xyz,2032-10-04
2472,5321,-2849,2003,10,5,xyz,2032-10-05
4117,9342,-5225,2003,10,6,xyz,2032-10-06
4078,967,3111,2003,10,7,xyz,2032-10-07
7192,2910,4282,2003,10,8,xyz,2032-10-08
4274,3052,1222,2003,10,9,xyz,2032-10-09
9267,9231,36,2003,10,10,xyz,2032-10-10
9782,998,8784,2003,10,11,xyz,2032-10-11
4659,4100,559,2003,10,12,xyz,2032-10-12
7149,5470,1679,2003,10,13,xyz,2032-10-13
5435,3290,2145,2003,10,14,xyz,2032-10-14
1735,3701,-1966,2003,10,15,xyz,2032-10-15
9309,911,8398,2003,10,16,xyz,2032-10-16
1003,1409,-406,2003,10,17,xyz,2032-10-17
7430,9745,-2315,2003,10,18,xyz,2032-10-18
9490,3063,6427,2003,10,19,xyz,2032-10-19
5622,8203,-2581,2003,10,20,xyz,2032-10-20
7823,5179,2644,2003,10,21,xyz,2032-10-21
9612,1498,8114,2003,10,22,xyz,2032-10-22
2749,3142,-393,2003,10,23,xyz,2032-10-23
8355,6024,2331,2003,10,24,xyz,2032-10-24
4705,7145,-2440,2003,10,25,xyz,2032-10-25
7605,6808,797,2003,10,26,xyz,2032-10-26
8591,4597,3994,2003,10,27,xyz,2032-10-27
6504,9147,-2643,2003,10,28,xyz,2032-10-28
1673,1954,-281,2003,10,29,xyz,2032-10-29
6475,6280,195,2003,10,30,xyz,2032-10-30
1439,1897,-458,2003,10,31,xyz,2032-10-31
4234,4165,69,2003,11,1,xyz,2032-11-01
7988,1543,6445,2003,11,2,xyz,2032-11-02
6878,5849,1029,2003,11,3,xyz,2032-11-03
8839,3511,5328,2003,11,4,xyz,2032-11-04
2935,4268,-1333,2003,11,5,xyz,2032-11-05
9691,3143,6548,2003,11,6,xyz,2032-11-06
8459,5109,3350,2003,11,7,xyz,2032-11-07
5954,8003,-2049,2003,11,8,xyz,2032-11-08
8576,2275,6301,2003,11,9,xyz,2032-11-09
3034,8361,-5327,2003,11,10,xyz,2032-11-10
7724,8118,-394,2003,11,11,xyz,2032-11-11
7635,4538,3097,2003,11,12,xyz,2032-11-12
6906,5815,1091,2003,11,13,xyz,2032-11-13
5860,3677,2183,2003,11,14,xyz,2032-11-14
8406,5710,2696,2003,11,15,xyz,2032-11-15
5826,1367,4459,2003,11,16,xyz,2032-11-16
5114,2467,2647,2003,11,17,xyz,2032-11-17
3309,4019,-710,2003,11,18,xyz,2032-11-18
4024,8623,-4599,2003,11,19,xyz,2032-11-19
9329,2067,7262,2003,11,20,xyz,2032-11-20
7116,1522,5594,2003,11,21,xyz,2032-11-21
2336,9983,-7647,2003,11,22,xyz,2032-11-22
1197,631,566,2003,11,23,xyz,2032-11-23
8947,4258,4689,2003,11,24,xyz,2032-11-24
7358,6609,749,2003,11,25,xyz,2032-11-25
4346,6789,-2443,2003,11,26,xyz,2032-11-26
3710,3689,21,2003,11,27,xyz,2032-11-27
8921,1138,7783,2003,11,28,xyz,2032-11-28
9252,546,8706,2003,11,29,xyz,2032-11-29
8073,1139,6934,2003,11,30,xyz,2032-11-30
9968,1525,8443,2003,12,1,xyz,2032-12-01
4778,8673,-3895,2003,12,2,xyz,2032-12-02
6705,1361,5344,2003,12,3,xyz,2032-12-03
6096,5542,554,2003,12,4,xyz,2032-12-04
9730,9090,640,2003,12,5,xyz,2032-12-05
2627,1625,1002,2003,12,6,xyz,2032-12-06
1801,5637,-3836,2003,12,7,xyz,2032-12-07
8354,7160,1194,2003,12,8,xyz,2032-12-08
3012,8589,-5577,2003,12,9,xyz,2032-12-09
4556,6093,-1537,2003,12,10,xyz,2032-12-10
1906,6122,-4216,2003,12,11,xyz,2032-12-11
2696,1551,1145,2003,12,12,xyz,2032-12-12
3589,2626,963,2003,12,13,xyz,2032-12-13
4246,9297,-5051,2003,12,14,xyz,2032-12-14
8395,736,7659,2003,12,15,xyz,2032-12-15
1613,9446,-7833,2003,12,16,xyz,2032-12-16
5731,1887,3844,2003,12,17,xyz,2032-12-17
6641,1612,5029,2003,12,18,xyz,2032-12-18
9561,3269,6292,2003,12,19,xyz,2032-12-19
2545,1067,1478,2003,12,20,xyz,2032-12-20
2210,2488,-278,2003,12,21,xyz,2032-12-21
6575,3721,2854,2003,12,22,xyz,2032-12-22
3968,9565,-5597,2003,12,23,xyz,2032-12-23
3414,1376,2038,2003,12,24,xyz,2032-12-24
1567,4149,-2582,2003,12,25,xyz,2032-12-25
4098,6558,-2460,2003,12,26,xyz,2032-12-26
3471,8177,-4706,2003,12,27,xyz,2032-12-27
7910,8170,-260,2003,12,28,xyz,2032-12-28
9772,4725,5047,2003,12,29,xyz,2032-12-29
3093,539,2554,2003,12,30,xyz,2032-12-30
3623,3420,203,2003,12,31,xyz,2032-12-31
6257,2169,4088,2004,1,1,xyz,2033-01-01
5122,5524,-402,2004,1,2,xyz,2033-01-02
7199,2295,4904,2004,1,3,xyz,2033-01-03
9555,5546,4009,2004,1,4,xyz,2033-01-04
9351,8885,466,2004,1,5,xyz,2033-01-05
2214,7599,-5385,2004,1,6,xyz,2033-01-06
1881,9703,-7822,2004,1,7,xyz,2033-01-07
8164,6309,1855,2004,1,8,xyz,2033-01-08
3897,1901,1996,2004,1,9,xyz,2033-01-09
2731,3081,-350,2004,1,10,xyz,2033-01-10
4344,7617,-3273,2004,1,11,xyz,2033-01-11
3881,5449,-1568,2004,1,12,xyz,2033-01-12
6618,3184,3434,2004,1,13,xyz,2033-01-13
3022,6187,-3165,2004,1,14,xyz,2033-01-14
6365,6789,-424,2004,1,15,xyz,2033-01-15
5338,6938,-1600,2004,1,16,xyz,2033-01-16
6646,1219,5427,2004,1,17,xyz,2033-01-17
3733,9718,-5985,2004,1,18,xyz,2033-01-18
2796,4584,-1788,2004,1,19,xyz,2033-01-19
9196,9842,-646,2004,1,20,xyz,2033-01-20
4634,2184,2450,2004,1,21,xyz,2033-01-21
5270,1456,3814,2004,1,22,xyz,2033-01-22
7371,2407,4964,2004,1,23,xyz,2033-01-23
4409,1882,2527,2004,1,24,xyz,2033-01-24
5947,2817,3130,2004,1,25,xyz,2033-01-25
2229,5301,-3072,2004,1,26,xyz,2033-01-26
4055,4773,-718,2004,1,27,xyz,2033-01-27
3747,6433,-2686,2004,1,28,xyz,2033-01-28
9960,3815,6145,2004,1,29,xyz,2033-01-29
1381,2593,-1212,2004,1,30,xyz,2033-01-30
8587,6801,1786,2004,1,31,xyz,2033-01-31
9970,919,9051,2004,2,1,xyz,2033-02-01
4149,7597,-3448,2004,2,2,xyz,2033-02-02
1687,4554,-2867,2004,2,3,xyz,2033-02-03
8142,6607,1535,2004,2,4,xyz,2033-02-04
3290,7383,-4093,2004,2,5,xyz,2033-02-05
5431,1560,3871,2004,2,6,xyz,2033-02-06
7679,4330,3349,2004,2,7,xyz,2033-02-07
8733,6655,2078,2004,2,8,xyz,2033-02-08
4412,6039,-1627,2004,2,9,xyz,2033-02-09
4302,2759,1543,2004,2,10,xyz,2033-02-10
4405,1447,2958,2004,2,11,xyz,2033-02-11
5516,3512,2004,2004,2,12,xyz,2033-02-12
9391,9323,68,2004,2,13,xyz,2033-02-13
3377,4227,-850,2004,2,14,xyz,2033-02-14
3601,4618,-1017,2004,2,15,xyz,2033-02-15
7534,6498,1036,2004,2,16,xyz,2033-02-16
7897,4892,3005,2004,2,17,xyz,2033-02-17
8783,5351,3432,2004,2,18,xyz,2033-02-18
7248,4343,2905,2004,2,19,xyz,2033-02-19
2518,4762,-2244,2004,2,20,xyz,2033-02-20
9844,672,9172,2004,2,21,xyz,2033-02-21
1668,6220,-4552,2004,2,22,xyz,2033-02-22
1151,6586,-5435,2004,2,23,xyz,2033-02-23
8692,760,7932,2004,2,24,xyz,2033-02-24
1259,8957,-7698,2004,2,25,xyz,2033-02-25
8891,3975,4916,2004,2,26,xyz,2033-02-26
1975,9656,-7681,2004,2,27,xyz,2033-02-27
4756,5535,-779,2004,2,28,xyz,2033-02-28
8714,6630,2084,2004,3,1,xyz,2033-03-01
8561,1373,7188,2004,3,2,xyz,2033-03-02
4934,8112,-3178,2004,3,3,xyz,2033-03-03
6186,9515,-3329,2004,3,4,xyz,2033-03-04
9318,8783,535,2004,3,5,xyz,2033-03-05
9141,4997,4144,2004,3,6,xyz,2033-03-06
3465,7675,-4210,2004,3,7,xyz,2033-03-07
4531,5702,-1171,2004,3,8,xyz,2033-03-08
9081,3635,5446,2004,3,9,xyz,2033-03-09
6633,8008,-1375,2004,3,10,xyz,2033-03-10
4947,5793,-846,2004,3,11,xyz,2033-03-11
3132,8243,-5111,2004,3,12,xyz,2033-03-12
8430,5604,2826,2004,3,13,xyz,2033-03-13
3524,1783,1741,2004,3,14,xyz,2033-03-14
7598,8223,-625,2004,3,15,xyz,2033-03-15
9040,2170,6870,2004,3,16,xyz,2033-03-16
7256,2532,4724,2004,3,17,xyz,2033-03-17
7606,7162,444,2004,3,18,xyz,2033-03-18
4083,3633,450,2004,3,19,xyz,2033-03-19
8655,2934,5721,2004,3,20,xyz,2033-03-20
9602,4607,4995,2004,3,21,xyz,2033-03-21
2943,2205,738,2004,3,22,xyz,2033-03-22
6414,2748,3666,2004,3,23,xyz,2033-03-23
2036,7592,-5556,2004,3,24,xyz,2033-03-24
6382,4228,2154,2004,3,25,xyz,2033-03-25
5148,3857,1291,2004,3,26,xyz,2033-03-26
4355,6200,-1845,2004,3,27,xyz,2033-03-27
7366,5216,2150,2004,3,28,xyz,2033-03-28
1907,4526,-2619,2004,3,29,xyz,2033-03-29
8448,6139,2309,2004,3,30,xyz,2033-03-30
7761,6230,1531,2004,3,31,xyz,2033-03-31
6979,831,6148,2004,4,1,xyz,2033-04-01
6234,3721,2513,2004,4,2,xyz,2033-04-02
3371,3506,-135,2004,4,3,xyz,2033-04-03
5655,6312,-657,2004,4,4,xyz,2033-04-04
4659,5672,-1013,2004,4,5,xyz,2033-04-05
7531,5231,2300,2004,4,6,xyz,2033-04-06
4765,4886,-121,2004,4,7,xyz,2033-04-07
5161,8532,-3371,2004,4,8,xyz,2033-04-08
5240,1638,3602,2004,4,9,xyz,2033-04-09
5131,6883,-1752,2004,4,10,xyz,2033-04-10
4823,9417,-4594,2004,4,11,xyz,2033-04-11
9417,6551,2866,2004,4,12,xyz,2033-04-12
3021,5401,-2380,2004,4,13,xyz,2033-04-13
2840,706,2134,2004,4,14,xyz,2033-04-14
8420,9024,-604,2004,4,15,xyz,2033-04-15
3004,2808,196,2004,4,16,xyz,2033-04-16
2006,5679,-3673,2004,4,17,xyz,2033-04-17
3393,4241,-848,2004,4,18,xyz,2033-04-18
8554,5528,3026,2004,4,19,xyz,2033-04-19
2840,8231,-5391,2004,4,20,xyz,2033-04-20
7474,8393,-919,2004,4,21,xyz,2033-04-21
4743,5884,-1141,2004,4,22,xyz,2033-04-22
2526,9717,-7191,2004,4,23,xyz,2033-04-23
3145,7322,-4177,2004,4,24,xyz,2033-04-24
7818,5067,2751,2004,4,25,xyz,2033-04-25
7916,4778,3138,2004,4,26,xyz,2033-04-26
8485,6817,1668,2004,4,27,xyz,2033-04-27
5825,7912,-2087,2004,4,28,xyz,2033-04-28
5364,5484,-120,2004,4,29,xyz,2033-04-29
6714,1227,5487,2004,4,30,xyz,2033-04-30
5821,7407,-1586,2004,5,1,xyz,2033-05-01
9777,7403,2374,2004,5,2,xyz,2033-05-02
2961,511,2450,2004,5,3,xyz,2033-05-03
9276,5009,4267,2004,5,4,xyz,2033-05-04
3966,3744,222,2004,5,5,xyz,2033-05-05
8735,1469,7266,2004,5,6,xyz,2033-05-06
4642,8694,-4052,2004,5,7,xyz,2033-05-07
6166,3425,2741,2004,5,8,xyz,2033-05-08
1959,8251,-6292,2004,5,9,xyz,2033-05-09
7291,5038,2253,2004,5,10,xyz,2033-05-10
7940,2308,5632,2004,5,11,xyz,2033-05-11
2162,567,1595,2004,5,12,xyz,2033-05-12
2703,3971,-1268,2004,5,13,xyz,2033-05-13
4767,6308,-1541,2004,5,14,xyz,2033-05-14
2965,7131,-4166,2004,5,15,xyz,2033-05-15
4403,1038,3365,2004,5,16,xyz,2033-05-16
6189,2617,3572,2004,5,17,xyz,2033-05-17
4142,9820,-5678,2004,5,18,xyz,2033-05-18
4223,5238,-1015,2004,5,19,xyz,2033-05-19
4527,7801,-3274,2004,5,20,xyz,2033-05-20
7618,894,6724,2004,5,21,xyz,2033-05-21
3138,2475,663,2004,5,22,xyz,2033-05-22
1412,5567,-4155,2004,5,23,xyz,2033-05-23
4007,1967,2040,2004,5,24,xyz,2033-05-24
8439,3760,4679,2004,5,25,xyz,2033-05-25
6206,7875,-1669,2004,5,26,xyz,2033-05-26
1117,6427,-5310,2004,5,27,xyz,2033-05-27
4556,8006,-3450,2004,5,28,xyz,2033-05-28
3119,5874,-2755,2004,5,29,xyz,2033-05-29
6374,4039,2335,2004,5,30,xyz,2033-05-30
2000,7672,-5672,2004,5,31,xyz,2033-05-31
6776,7311,-535,2004,6,1,xyz,2033-06-01
3122,2592,530,2004,6,2,xyz,2033-06-02
7494,7487,7,2004,6,3,xyz,2033-06-03
1052,1751,-699,2004,6,4,xyz,2033-06-04
9789,3735,6054,2004,6,5,xyz,2033-06-05
9521,3728,5793,2004,6,6,xyz,2033-06-06
8254,933,7321,2004,6,7,xyz,2033-06-07
5832,736,5096,2004,6,8,xyz,2033-06-08
2106,9450,-7344,2004,6,9,xyz,2033-06-09
2774,4157,-1383,2004,6,10,xyz,2033-06-10
7899,7474,425,2004,6,11,xyz,2033-06-11
7203,1547,5656,2004,6,12,xyz,2033-06-12
3700,7137,-3437,2004,6,13,xyz,2033-06-13
5696,4586,1110,2004,6,14,xyz,2033-06-14
3588,1493,2095,2004,6,15,xyz,2033-06-15
5609,4040,1569,2004,6,16,xyz,2033-06-16
9063,6608,2455,2004,6,17,xyz,2033-06-17
1522,2349,-827,2004,6,18,xyz,2033-06-18
2218,6582,-4364,2004,6,19,xyz,2033-06-19
7534,6866,668,2004,6,20,xyz,2033-06-20
5549,9390,-3841,2004,6,21,xyz,2033-06-21
6775,4971,1804,2004,6,22,xyz,2033-06-22
9219,2785,6434,2004,6,23,xyz,2033-06-23
2166,3658,-1492,2004,6,24,xyz,2033-06-24
3116,1309,1807,2004,6,25,xyz,2033-06-25
3516,559,2957,2004,6,26,xyz,2033-06-26
8430,4020,4410,2004,6,27,xyz,2033-06-27
4330,794,3536,2004,6,28,xyz,2033-06-28
4834,6774,-1940,2004,6,29,xyz,2033-06-29
6060,9025,-2965,2004,6,30,xyz,2033-06-30
4459,8894,-4435,2004,7,1,xyz,2033-07-01
1756,4554,-2798,2004,7,2,xyz,2033-07-02
2220,6650,-4430,2004,7,3,xyz,2033-07-03
8506,5522,2984,2004,7,4,xyz,2033-07-04
3054,3602,-548,2004,7,5,xyz,2033-07-05
1548,3212,-1664,2004,7,6,xyz,2033-07-06
1952,592,1360,2004,7,7,xyz,2033-07-07
6510,7240,-730,2004,7,8,xyz,2033-07-08
8490,3345,5145,2004,7,9,xyz,2033-07-09
8372,3450,4922,2004,7,10,xyz,2033-07-10
3520,1456,2064,2004,7,11,xyz,2033-07-11
4789,9264,-4475,2004,7,12,xyz,2033-07-12
8812,7343,1469,2004,7,13,xyz,2033-07-13
5149,9546,-4397,2004,7,14,xyz,2033-07-14
9792,5997,3795,2004,7,15,xyz,2033-07-15
6916,2649,4267,2004,7,16,xyz,2033-07-16
4149,9959,-5810,2004,7,17,xyz,2033-07-17
1301,754,547,2004,7,18,xyz,2033-07-18
6354,859,5495,2004,7,19,xyz,2033-07-19
3274,1437,1837,2004,7,20,xyz,2033-07-20
6269,1386,4883,2004,7,21,xyz,2033-07-21
1206,1478,-272,2004,7,22,xyz,2033-07-22
9475,6529,2946,2004,7,23,xyz,2033-07-23
6553,9912,-3359,2004,7,24,xyz,2033-07-24
9269,2641,6628,2004,7,25,xyz,2033-07-25
9914,3564,6350,2004,7,26,xyz,2033-07-26
1640,6871,-5231,2004,7,27,xyz,2033-07-27
7686,8118,-432,2004,7,28,xyz,2033-07-28
6337,8359,-2022,2004,7,29,xyz,2033-07-29
5444,9425,-3981,2004,7,30,xyz,2033-07-30
7563,4458,3105,2004,7,31,xyz,2033-07-31
2306,9019,-6713,2004,8,1,xyz,2033-08-01
3534,6562,-3028,2004,8,2,xyz,2033-08-02
1940,5275,-3335,2004,8,3,xyz,2033-08-03
2412,9378,-6966,2004,8,4,xyz,2033-08-04
4420,2690,1730,2004,8,5,xyz,2033-08-05
3158,6372,-3214,2004,8,6,xyz,2033-08-06
8927,1171,7756,2004,8,7,xyz,2033-08-07
1548,1054,494,2004,8,8,xyz,2033-08-08
1165,2911,-1746,2004,8,9,xyz,2033-08-09
5606,9626,-4020,2004,8,10,xyz,2033-08-10
3706,1585,2121,2004,8,11,xyz,2033-08-11
5168,1339,3829,2004,8,12,xyz,2033-08-12
8383,2221,6162,2004,8,13,xyz,2033-08-13
1331,6820,-5489,2004,8,14,xyz,2033-08-14
8976,7612,1364,2004,8,15,xyz,2033-08-15
6514,3300,3214,2004,8,16,xyz,2033-08-16
1759,3576,-1817,2004,8,17,xyz,2033-08-17
3360,8380,-5020,2004,8,18,xyz,2033-08-18
1092,7231,-6139,2004,8,19,xyz,2033-08-19
5805,1255,4550,2004,8,20,xyz,2033-08-20
5572,8933,-3361,2004,8,21,xyz,2033-08-21
6990,3128,3862,2004,8,22,xyz,2033-08-22
8936,5694,3242,2004,8,23,xyz,2033-08-23
1984,3167,-1183,2004,8,24,xyz,2033-08-24
3963,4311,-348,2004,8,25,xyz,2033-08-25
7675,6061,1614,2004,8,26,xyz,2033-08-26
9321,8388,933,2004,8,27,xyz,2033-08-27
9664,6141,3523,2004,8,28,xyz,2033-08-28
3778,8651,-4873,2004,8,29,xyz,2033-08-29
1947,7654,-5707,2004,8,30,xyz,2033-08-30
2422,5183,-2761,2004,8,31,xyz,2033-08-31
7081,8839,-1758,2004,9,1,xyz,2033-09-01
9061,9463,-402,2004,9,2,xyz,2033-09-02
2712,9881,-7169,2004,9,3,xyz,2033-09-03
2283,6961,-4678,2004,9,4,xyz,2033-09-04
1691,9459,-7768,2004,9,5,xyz,2033-09-05
2081,1501,580,2004,9,6,xyz,2033-09-06
8717,8710,7,2004,9,7,xyz,2033-09-07
1235,8409,-7174,2004,9,8,xyz,2033-09-08
6982,5263,1719,2004,9,9,xyz,2033-09-09
6256,8069,-1813,2004,9,10,xyz,2033-09-10
6501,9706,-3205,2004,9,11,xyz,2033-09-11
2646,2264,382,2004,9,12,xyz,2033-09-12
6318,7021,-703,2004,9,13,xyz,2033-09-13
4415,3581,834,2004,9,14,xyz,2033-09-14
3749,9038,-5289,2004,9,15,xyz,2033-09-15
2727,7965,-5238,2004,9,16,xyz,2033-09-16
1642,9053,-7411,2004,9,17,xyz,2033-09-17
2775,9694,-6919,2004,9,18,xyz,2033-09-18
3094,8242,-5148,2004,9,19,xyz,2033-09-19
6399,4496,1903,2004,9,20,xyz,2033-09-20
3679,3604,75,2004,9,21,xyz,2033-09-21
5509,1869,3640,2004,9,22,xyz,2033-09-22
1359,1283,76,2004,9,23,xyz,2033-09-23
9754,1934,7820,2004,9,24,xyz,2033-09-24
1978,9873,-7895,2004,9,25,xyz,2033-09-25
4744,650,4094,2004,9,26,xyz,2033-09-26
1945,8338,-6393,2004,9,27,xyz,2033-09-27
8922,7371,1551,2004,9,28,xyz,2033-09-28
2190,6343,-4153,2004,9,29,xyz,2033-09-29
4204,5296,-1092,2004,9,30,xyz,2033-09-30
7252,9508,-2256,2004,10,1,xyz,2033-10-01
3701,7143,-3442,2004,10,2,xyz,2033-10-02
7772,2342,5430,2004,10,3,xyz,2033-10-03
5088,1064,4024,2004,10,4,xyz,2033-10-04
1406,7592,-6186,2004,10,5,xyz,2033-10-05
9102,3233,5869,2004,10,6,xyz,2033-10-06
2766,4425,-1659,2004,10,7,xyz,2033-10-07
1894,2729,-835,2004,10,8,xyz,2033-10-08
1061,1805,-744,2004,10,9,xyz,2033-10-09
4816,1279,3537,2004,10,10,xyz,2033-10-10
4142,5416,-1274,2004,10,11,xyz,2033-10-11
2916,2555,361,2004,10,12,xyz,2033-10-12
1292,6680,-5388,2004,10,13,xyz,2033-10-13
8378,5071,3307,2004,10,14,xyz,2033-10-14
6792,9722,-2930,2004,10,15,xyz,2033-10-15
6579,6361,218,2004,10,16,xyz,2033-10-16
5905,3592,2313,2004,10,17,xyz,2033-10-17
6981,4385,2596,2004,10,18,xyz,2033-10-18
7411,7030,381,2004,10,19,xyz,2033-10-19
1608,5892,-4284,2004,10,20,xyz,2033-10-20
7036,1965,5071,2004,10,21,xyz,2033-10-21
5068,5737,-669,2004,10,22,xyz,2033-10-22
6714,2853,3861,2004,10,23,xyz,2033-10-23
6337,6347,-10,2004,10,24,xyz,2033-10-24
1552,5127,-3575,2004,10,25,xyz,2033-10-25
9382,2575,6807,2004,10,26,xyz,2033-10-26
4884,3495,1389,2004,10,27,xyz,2033-10-27
8411,8676,-265,2004,10,28,xyz,2033-10-28
8593,7421,1172,2004,10,29,xyz,2033-10-29
5848,1200,4648,2004,10,30,xyz,2033-10-30
4739,8039,-3300,2004,10,31,xyz,2033-10-31
5061,2185,2876,2004,11,1,xyz,2033-11-01
9547,6721,2826,2004,11,2,xyz,2033-11-02
3912,2142,1770,2004,11,3,xyz,2033-11-03
5509,567,4942,2004,11,4,xyz,2033-11-04
6130,9217,-3087,2004,11,5,xyz,2033-11-05
1117,2701,-1584,2004,11,6,xyz,2033-11-06
5029,8987,-3958,2004,11,7,xyz,2033-11-07
3221,9225,-6004,2004,11,8,xyz,2033-11-08
7958,6281,1677,2004,11,9,xyz,2033-11-09
9390,6561,2829,2004,11,10,xyz,2033-11-10
2022,6277,-4255,2004,11,11,xyz,2033-11-11
5004,9032,-4028,2004,11,12,xyz,2033-11-12
4805,7153,-2348,2004,11,13,xyz,2033-11-13
8006,3484,4522,2004,11,14,xyz,2033-11-14
7705,2542,5163,2004,11,15,xyz,2033-11-15
7491,7786,-295,2004,11,16,xyz,2033-11-16
2474,8630,-6156,2004,11,17,xyz,2033-11-17
2485,8708,-6223,2004,11,18,xyz,2033-11-18
2593,5148,-2555,2004,11,19,xyz,2033-11-19
1522,6566,-5044,2004,11,20,xyz,2033-11-20
6298,2240,4058,2004,11,21,xyz,2033-11-21
2643,6616,-3973,2004,11,22,xyz,2033-11-22
5102,4833,269,2004,11,23,xyz,2033-11-23
9209,2632,6577,2004,11,24,xyz,2033-11-24
9721,4029,5692,2004,11,25,xyz,2033-11-25
8138,670,7468,2004,11,26,xyz,2033-11-26
5827,4561,1266,2004,11,27,xyz,2033-11-27
7101,2077,5024,2004,11,28,xyz,2033-11-28
7520,5358,2162,2004,11,29,xyz,2033-11-29
4350,1424,2926,2004,11,30,xyz,2033-11-30
8873,8315,558,2004,12,1,xyz,2033-12-01
7760,5590,2170,2004,12,2,xyz,2033-12-02
3563,9836,-6273,2004,12,3,xyz,2033-12-03
5106,4529,577,2004,12,4,xyz,2033-12-04
6905,8027,-1122,2004,12,5,xyz,2033-12-05
4151,1232,2919,2004,12,6,xyz,2033-12-06
5964,8017,-2053,2004,12,7,xyz,2033-12-07
4468,1587,2881,2004,12,8,xyz,2033-12-08
8989,4215,4774,2004,12,9,xyz,2033-12-09
3469,2514,955,2004,12,10,xyz,2033-12-10
3527,4054,-527,2004,12,11,xyz,2033-12-11
3756,2921,835,2004,12,12,xyz,2033-12-12
9724,1761,7963,2004,12,13,xyz,2033-12-13
4079,1112,2967,2004,12,14,xyz,2033-12-14
1131,4357,-3226,2004,12,15,xyz,2033-12-15
1569,3085,-1516,2004,12,16,xyz,2033-12-16
5022,820,4202,2004,12,17,xyz,2033-12-17
6850,996,5854,2004,12,18,xyz,2033-12-18
8784,3619,5165,2004,12,19,xyz,2033-12-19
9621,5196,4425,2004,12,20,xyz,2033-12-20
8619,4911,3708,2004,12,21,xyz,2033-12-21
2892,2120,772,2004,12,22,xyz,2033-12-22
6115,7415,-1300,2004,12,23,xyz,2033-12-23
5685,5088,597,2004,12,24,xyz,2033-12-24
8588,7488,1100,2004,12,25,xyz,2033-12-25
4636,9542,-4906,2004,12,26,xyz,2033-12-26
6128,5921,207,2004,12,27,xyz,2033-12-27
6963,6078,885,2004,12,28,xyz,2033-12-28
8626,9381,-755,2004,12,29,xyz,2033-12-29
8140,9690,-1550,2004,12,30,xyz,2033-12-30
3763,1436,2327,2004,12,31,xyz,2033-12-31
8965,5218,3747,2005,1,1,xyz,2034-01-01
9223,802,8421,2005,1,2,xyz,2034-01-02
2341,3289,-948,2005,1,3,xyz,2034-01-03
9897,4386,5511,2005,1,4,xyz,2034-01-04
6687,5510,1177,2005,1,5,xyz,2034-01-05
1909,1989,-80,2005,1,6,xyz,2034-01-06
1996,4342,-2346,2005,1,7,xyz,2034-01-07
7103,1296,5807,2005,1,8,xyz,2034-01-08
5047,1775,3272,2005,1,9,xyz,2034-01-09
6703,8051,-1348,2005,1,10,xyz,2034-01-10
1991,6231,-4240,2005,1,11,xyz,2034-01-11
8876,1067,7809,2005,1,12,xyz,2034-01-12
6710,2916,3794,2005,1,13,xyz,2034-01-13
1441,7046,-5605,2005,1,14,xyz,2034-01-14
8882,1139,7743,2005,1,15,xyz,2034-01-15
9441,3121,6320,2005,1,16,xyz,2034-01-16
4983,5841,-858,2005,1,17,xyz,2034-01-17
3977,583,3394,2005,1,18,xyz,2034-01-18
6436,6728,-292,2005,1,19,xyz,2034-01-19
1320,2946,-1626,2005,1,20,xyz,2034-01-20
3741,2342,1399,2005,1,21,xyz,2034-01-21
9002,866,8136,2005,1,22,xyz,2034-01-22
3054,5986,-2932,2005,1,23,xyz,2034-01-23
2639,7399,-4760,2005,1,24,xyz,2034-01-24
1725,8123,-6398,2005,1,25,xyz,2034-01-25
9704,9117,587,2005,1,26,xyz,2034-01-26
2450,9325,-6875,2005,1,27,xyz,2034-01-27
3604,4032,-428,2005,1,28,xyz,2034-01-28
2039,9003,-6964,2005,1,29,xyz,2034-01-29
3241,3326,-85,2005,1,30,xyz,2034-01-30
6780,2543,4237,2005,1,31,xyz,2034-01-31
4183,7872,-3689,2005,2,1,xyz,2034-02-01
4644,4175,469,2005,2,2,xyz,2034-02-02
8875,7780,1095,2005,2,3,xyz,2034-02-03
8921,9187,-266,2005,2,4,xyz,2034-02-04
5560,2979,2581,2005,2,5,xyz,2034-02-05
5125,2364,2761,2005,2,6,xyz,2034-02-06
1761,1423,338,2005,2,7,xyz,2034-02-07
7402,9729,-2327,2005,2,8,xyz,2034-02-08
4071,9152,-5081,2005,2,9,xyz,2034-02-09
3826,4476,-650,2005,2,10,xyz,2034-02-10
4860,3942,918,2005,2,11,xyz,2034-02-11
9101,7709,1392,2005,2,12,xyz,2034-02-12
1036,607,429,2005,2,13,xyz,2034-02-13
7593,9549,-1956,2005,2,14,xyz,2034-02-14
5969,1435,4534,2005,2,15,xyz,2034-02-15
2022,8235,-6213,2005,2,16,xyz,2034-02-16
3931,5167,-1236,2005,2,17,xyz,2034-02-17
6397,4618,1779,2005,2,18,xyz,2034-02-18
2892,4282,-1390,2005,2,19,xyz,2034-02-19
9049,2630,6419,2005,2,20,xyz,2034-02-20
3873,5739,-1866,2005,2,21,xyz,2034-02-21
4712,4781,-69,2005,2,22,xyz,2034-02-22
1042,5727,-4685,2005,2,23,xyz,2034-02-23
4609,4163,446,2005,2,24,xyz,2034-02-24
4148,2192,1956,2005,2,25,xyz,2034-02-25
2363,5327,-2964,2005,2,26,xyz,2034-02-26
1808,706,1102,2005,2,27,xyz,2034-02-27
9018,9778,-760,2005,2,28,xyz,2034-02-28
7035,2707,4328,2005,3,1,xyz,2034-03-01
9543,2180,7363,2005,3,2,xyz,2034-03-02
9572,8297,1275,2005,3,3,xyz,2034-03-03
5514,3784,1730,2005,3,4,xyz,2034-03-04
5356,3998,1358,2005,3,5,xyz,2034-03-05
6929,7866,-937,2005,3,6,xyz,2034-03-06
4502,8998,-4496,2005,3,7,xyz,2034-03-07
3013,788,2225,2005,3,8,xyz,2034-03-08
4549,4935,-386,2005,3,9,xyz,2034-03-09
1520,3997,-2477,2005,3,10,xyz,2034-03-10
9979,7164,2815,2005,3,11,xyz,2034-03-11
4326,9683,-5357,2005,3,12,xyz,2034-03-12
8925,2069,6856,2005,3,13,xyz,2034-03-13
6181,4479,1702,2005,3,14,xyz,2034-03-14
6520,6343,177,2005,3,15,xyz,2034-03-15
8951,2146,6805,2005,3,16,xyz,2034-03-16
8311,3146,5165,2005,3,17,xyz,2034-03-17
9522,8352,1170,2005,3,18,xyz,2034-03-18
9525,7007,2518,2005,3,19,xyz,2034-03-19
8704,4125,4579,2005,3,20,xyz,2034-03-20
3978,5959,-1981,2005,3,21,xyz,2034-03-21
2947,1800,1147,2005,3,22,xyz,2034-03-22
7808,1228,6580,2005,3,23,xyz,2034-03-23
6455,7050,-595,2005,3,24,xyz,2034-03-24
1585,7972,-6387,2005,3,25,xyz,2034-03-25
5690,8246,-2556,2005,3,26,xyz,2034-03-26
5640,3764,1876,2005,3,27,xyz,2034-03-27
9613,9166,447,2005,3,28,xyz,2034-03-28
2364,1852,512,2005,3,29,xyz,2034-03-29
3516,5664,-2148,2005,3,30,xyz,2034-03-30
5506,8378,-2872,2005,3,31,xyz,2034-03-31
2408,5738,-3330,2005,4,1,xyz,2034-04-01
6989,4996,1993,2005,4,2,xyz,2034-04-02
6080,8050,-1970,2005,4,3,xyz,2034-04-03
2847,665,2182,2005,4,4,xyz,2034-04-04
1450,5939,-4489,2005,4,5,xyz,2034-04-05
3859,7961,-4102,2005,4,6,xyz,2034-04-06
7259,3052,4207,2005,4,7,xyz,2034-04-07
4467,1678,2789,2005,4,8,xyz,2034-04-08
7841,1597,6244,2005,4,9,xyz,2034-04-09
3806,2717,1089,2005,4,10,xyz,2034-04-10
1538,3694,-2156,2005,4,11,xyz,2034-04-11
3463,4587,-1124,2005,4,12,xyz,2034-04-12
2702,6242,-3540,2005,4,13,xyz,2034-04-13
3583,7702,-4119,2005,4,14,xyz,2034-04-14
3990,2275,1715,2005,4,15,xyz,2034-04-15
2013,6802,-4789,2005,4,16,xyz,2034-04-16
8037,3654,4383,2005,4,17,xyz,2034-04-17
3617,6570,-2953,2005,4,18,xyz,2034-04-18
2941,6086,-3145,2005,4,19,xyz,2034-04-19
4628,2390,2238,2005,4,20,xyz,2034-04-20
3033,3553,-520,2005,4,21,xyz,2034-04-21
3023,7910,-4887,2005,4,22,xyz,2034-04-22
7252,9638,-2386,2005,4,23,xyz,2034-04-23
9252,1364,7888,2005,4,24,xyz,2034-04-24
3612,4729,-1117,2005,4,25,xyz,2034-04-25
5765,1996,3769,2005,4,26,xyz,2034-04-26
5932,9161,-3229,2005,4,27,xyz,2034-04-27
9892,1624,8268,2005,4,28,xyz,2034-04-28
1478,4654,-3176,2005,4,29,xyz,2034-04-29
9826,4487,5339,2005,4,30,xyz,2034-04-30
7318,8254,-936,2005,5,1,xyz,2034-05-01
7185,2193,4992,2005,5,2,xyz,2034-05-02
9084,9835,-751,2005,5,3,xyz,2034-05-03
9526,2958,6568,2005,5,4,xyz,2034-05-04
3318,1786,1532,2005,5,5,xyz,2034-05-05
3597,1572,2025,2005,5,6,xyz,2034-05-06
4156,9865,-5709,2005,5,7,xyz,2034-05-07
4836,9222,-4386,2005,5,8,xyz,2034-05-08
5672,5784,-112,2005,5,9,xyz,2034-05-09
7912,9942,-2030,2005,5,10,xyz,2034-05-10
3362,6487,-3125,2005,5,11,xyz,2034-05-11
1149,5909,-4760,2005,5,12,xyz,2034-05-12
6368,5748,620,2005,5,13,xyz,2034-05-13
3433,7532,-4099,2005,5,14,xyz,2034-05-14
4251,2389,1862,2005,5,15,xyz,2034-05-15
8838,6449,2389,2005,5,16,xyz,2034-05-16
9965,9474,491,2005,5,17,xyz,2034-05-17
1450,8402,-6952,2005,5,18,xyz,2034-05-18
2393,6513,-4120,2005,5,19,xyz,2034-05-19
5201,1834,3367,2005,5,20,xyz,2034-05-20
2196,6098,-3902,2005,5,21,xyz,2034-05-21
8211,3887,4324,2005,5,22,xyz,2034-05-22
3882,8690,-4808,2005,5,23,xyz,2034-05-23
5054,712,4342,2005,5,24,xyz,2034-05-24
3594,3695,-101,2005,5,25,xyz,2034-05-25
8500,5401,3099,2005,5,26,xyz,2034-05-26
5883,6007,-124,2005,5,27,xyz,2034-05-27
2309,5603,-3294,2005,5,28,xyz,2034-05-28
7276,4224,3052,2005,5,29,xyz,2034-05-29
6243,930,5313,2005,5,30,xyz,2034-05-30
9884,676,9208,2005,5,31,xyz,2034-05-31
9242,3550,5692,2005,6,1,xyz,2034-06-01
1235,3046,-1811,2005,6,2,xyz,2034-06-02
5957,1648,4309,2005,6,3,xyz,2034-06-03
2849,7110,-4261,2005,6,4,xyz,2034-06-04
8284,6578,1706,2005,6,5,xyz,2034-06-05
2951,1104,1847,2005,6,6,xyz,2034-06-06
1464,842,622,2005,6,7,xyz,2034-06-07
9021,7656,1365,2005,6,8,xyz,2034-06-08
5476,8453,-2977,2005,6,9,xyz,2034-06-09
2179,2009,170,2005,6,10,xyz,2034-06-10
7602,6808,794,2005,6,11,xyz,2034-06-11
6593,2963,3630,2005,6,12,xyz,2034-06-12
2097,5945,-3848,2005,6,13,xyz,2034-06-13
3870,7708,-3838,2005,6,14,xyz,2034-06-14
4307,9117,-4810,2005,6,15,xyz,2034-06-15
4241,5128,-887,2005,6,16,xyz,2034-06-16
1743,1170,573,2005,6,17,xyz,2034-06-17
5179,8258,-3079,2005,6,18,xyz,2034-06-18
3308,7182,-3874,2005,6,19,xyz,2034-06-19
6975,8794,-1819,2005,6,20,xyz,2034-06-20
2562,4765,-2203,2005,6,21,xyz,2034-06-21
2549,3510,-961,2005,6,22,xyz,2034-06-22
5120,6760,-1640,2005,6,23,xyz,2034-06-23
8603,3504,5099,2005,6,24,xyz,2034-06-24
2489,946,1543,2005,6,25,xyz,2034-06-25
5011,6537,-1526,2005,6,26,xyz,2034-06-26
7556,6432,1124,2005,6,27,xyz,2034-06-27
9307,2115,7192,2005,6,28,xyz,2034-06-28
4741,4949,-208,2005,6,29,xyz,2034-06-29
4566,3283,1283,2005,6,30,xyz,2034-06-30
3625,9198,-5573,2005,7,1,xyz,2034-07-01
3782,4124,-342,2005,7,2,xyz,2034-07-02
3136,7211,-4075,2005,7,3,xyz,2034-07-03
2718,4083,-1365,2005,7,4,xyz,2034-07-04
4648,772,3876,2005,7,5,xyz,2034-07-05
9766,3029,6737,2005,7,6,xyz,2034-07-06
1448,4636,-3188,2005,7,7,xyz,2034-07-07
7218,2566,4652,2005,7,8,xyz,2034-07-08
5474,8150,-2676,2005,7,9,xyz,2034-07-09
9812,8157,1655,2005,7,10,xyz,2034-07-10
3156,5688,-2532,2005,7,11,xyz,2034-07-11
5979,8754,-2775,2005,7,12,xyz,2034-07-12
4055,5296,-1241,2005,7,13,xyz,2034-07-13
6679,7626,-947,2005,7,14,xyz,2034-07-14
7765,5903,1862,2005,7,15,xyz,2034-07-15
3036,2647,389,2005,7,16,xyz,2034-07-16
7939,7068,871,2005,7,17,xyz,2034-07-17
2648,6173,-3525,2005,7,18,xyz,2034-07-18
3061,942,2119,2005,7,19,xyz,2034-07-19
9365,7028,2337,2005,7,20,xyz,2034-07-20
9471,8552,919,2005,7,21,xyz,2034-07-21
4621,4813,-192,2005,7,22,xyz,2034-07-22
2579,4925,-2346,2005,7,23,xyz,2034-07-23
1794,5709,-3915,2005,7,24,xyz,2034-07-24
1676,5521,-3845,2005,7,25,xyz,2034-07-25
7262,5798,1464,2005,7,26,xyz,2034-07-26
2153,4357,-2204,2005,7,27,xyz,2034-07-27
5121,9623,-4502,2005,7,28,xyz,2034-07-28
6468,1833,4635,2005,7,29,xyz,2034-07-29
2581,8926,-6345,2005,7,30,xyz,2034-07-30
7618,6349,1269,2005,7,31,xyz,2034-07-31
5411,5974,-563,2005,8,1,xyz,2034-08-01
9901,1794,8107,2005,8,2,xyz,2034-08-02
4051,522,3529,2005,8,3,xyz,2034-08-03
4051,643,3408,2005,8,4,xyz,2034-08-04
8598,2696,5902,2005,8,5,xyz,2034-08-05
4068,5402,-1334,2005,8,6,xyz,2034-08-06
6782,3304,3478,2005,8,7,xyz,2034-08-07
2508,9752,-7244,2005,8,8,xyz,2034-08-08
9260,6115,3145,2005,8,9,xyz,2034-08-09
7363,2104,5259,2005,8,10,xyz,2034-08-10
1721,6141,-4420,2005,8,11,xyz,2034-08-11
4188,1821,2367,2005,8,12,xyz,2034-08-12
5683,1382,4301,2005,8,13,xyz,2034-08-13
7202,5889,1313,2005,8,14,xyz,2034-08-14
2342,2391,-49,2005,8,15,xyz,2034-08-15
7796,7698,98,2005,8,16,xyz,2034-08-16
4425,4442,-17,2005,8,17,xyz,2034-08-17
9876,1083,8793,2005,8,18,xyz,2034-08-18
1620,9899,-8279,2005,8,19,xyz,2034-08-19
3242,4144,-902,2005,8,20,xyz,2034-08-20
9231,3990,5241,2005,8,21,xyz,2034-08-21
3012,3902,-890,2005,8,22,xyz,2034-08-22
4359,5468,-1109,2005,8,23,xyz,2034-08-23
1113,3925,-2812,2005,8,24,xyz,2034-08-24
5605,1184,4421,2005,8,25,xyz,2034-08-25
7309,8513,-1204,2005,8,26,xyz,2034-08-26
2274,2051,223,2005,8,27,xyz,2034-08-27
8460,2973,5487,2005,8,28,xyz,2034-08-28
6028,9382,-3354,2005,8,29,xyz,2034-08-29
3486,5376,-1890,2005,8,30,xyz,2034-08-30
5696,9100,-3404,2005,8,31,xyz,2034-08-31
2103,5140,-3037,2005,9,1,xyz,2034-09-01
5839,6031,-192,2005,9,2,xyz,2034-09-02
3474,2124,1350,2005,9,3,xyz,2034-09-03
9958,6984,2974,2005,9,4,xyz,2034-09-04
1717,1707,10,2005,9,5,xyz,2034-09-05
8732,4660,4072,2005,9,6,xyz,2034-09-06
8562,2817,5745,2005,9,7,xyz,2034-09-07
9702,4944,4758,2005,9,8,xyz,2034-09-08
1030,1463,-433,2005,9,9,xyz,2034-09-09
8527,2105,6422,2005,9,10,xyz,2034-09-10
9693,5228,4465,2005,9,11,xyz,2034-09-11
6905,5210,1695,2005,9,12,xyz,2034-09-12
3995,3980,15,2005,9,13,xyz,2034-09-13
8404,6943,1461,2005,9,14,xyz,2034-09-14
8750,3068,5682,2005,9,15,xyz,2034-09-15
5154,668,4486,2005,9,16,xyz,2034-09-16
1868,6388,-4520,2005,9,17,xyz,2034-09-17
8938,1115,7823,2005,9,18,xyz,2034-09-18
7344,4125,3219,2005,9,19,xyz,2034-09-19
7841,759,7082,2005,9,20,xyz,2034-09-20
2989,5395,-2406,2005,9,21,xyz,2034-09-21
5676,3608,2068,2005,9,22,xyz,2034-09-22
9122,6796,2326,2005,9,23,xyz,2034-09-23
7228,5509,1719,2005,9,24,xyz,2034-09-24
3515,6199,-2684,2005,9,25,xyz,2034-09-25
2304,8220,-5916,2005,9,26,xyz,2034-09-26
2736,1697,1039,2005,9,27,xyz,2034-09-27
4787,3509,1278,2005,9,28,xyz,2034-09-28
4339,4032,307,2005,9,29,xyz,2034-09-29
7018,8976,-1958,2005,9,30,xyz,2034-09-30
9985,5059,4926,2005,10,1,xyz,2034-10-01
8795,6052,2743,2005,10,2,xyz,2034-10-02
4848,9629,-4781,2005,10,3,xyz,2034-10-03
6899,5568,1331,2005,10,4,xyz,2034-10-04
3784,630,3154,2005,10,5,xyz,2034-10-05
9390,8683,707,2005,10,6,xyz,2034-10-06
9407,4474,4933,2005,10,7,xyz,2034-10-07
8602,8214,388,2005,10,8,xyz,2034-10-08
5271,6215,-944,2005,10,9,xyz,2034-10-09
9194,1075,8119,2005,10,10,xyz,2034-10-10
1082,1723,-641,2005,10,11,xyz,2034-10-11
5590,4663,927,2005,10,12,xyz,2034-10-12
6267,833,5434,2005,10,13,xyz,2034-10-13
7477,7842,-365,2005,10,14,xyz,2034-10-14
7493,2212,5281,2005,10,15,xyz,2034-10-15
9768,9709,59,2005,10,16,xyz,2034-10-16
4748,9896,-5148,2005,10,17,xyz,2034-10-17
5846,9719,-3873,2005,10,18,xyz,2034-10-18
2125,9913,-7788,2005,10,19,xyz,2034-10-19
5007,3671,1336,2005,10,20,xyz,2034-10-20
1567,8538,-6971,2005,10,21,xyz,2034-10-21
2160,9781,-7621,2005,10,22,xyz,2034-10-22
1870,3322,-1452,2005,10,23,xyz,2034-10-23
7246,9600,-2354,2005,10,24,xyz,2034-10-24
4887,7203,-2316,2005,10,25,xyz,2034-10-25
2852,628,2224,2005,10,26,xyz,2034-10-26
6689,3773,2916,2005,10,27,xyz,2034-10-27
1797,9139,-7342,2005,10,28,xyz,2034-10-28
2921,4533,-1612,2005,10,29,xyz,2034-10-29
1918,4018,-2100,2005,10,30,xyz,2034-10-30
7351,6508,843,2005,10,31,xyz,2034-10-31
1263,8282,-7019,2005,11,1,xyz,2034-11-01
7382,5359,2023,2005,11,2,xyz,2034-11-02
7966,7623,343,2005,11,3,xyz,2034-11-03
4722,5995,-1273,2005,11,4,xyz,2034-11-04
6417,2973,3444,2005,11,5,xyz,2034-11-05
9315,3625,5690,2005,11,6,xyz,2034-11-06
7751,9865,-2114,2005,11,7,xyz,2034-11-07
5183,8858,-3675,2005,11,8,xyz,2034-11-08
2631,4280,-1649,2005,11,9,xyz,2034-11-09
6034,8003,-1969,2005,11,10,xyz,2034-11-10
1407,2502,-1095,2005,11,11,xyz,2034-11-11
2143,7863,-5720,2005,11,12,xyz,2034-11-12
2995,2455,540,2005,11,13,xyz,2034-11-13
8506,917,7589,2005,11,14,xyz,2034-11-14
2872,7612,-4740,2005,11,15,xyz,2034-11-15
8129,6864,1265,2005,11,16,xyz,2034-11-16
8768,4104,4664,2005,11,17,xyz,2034-11-17
8274,1910,6364,2005,11,18,xyz,2034-11-18
3324,3499,-175,2005,11,19,xyz,2034-11-19
8857,9288,-431,2005,11,20,xyz,2034-11-20
4774,4991,-217,2005,11,21,xyz,2034-11-21
5509,1288,4221,2005,11,22,xyz,2034-11-22
6709,3434,3275,2005,11,23,xyz,2034-11-23
1780,8930,-7150,2005,11,24,xyz,2034-11-24
5240,755,4485,2005,11,25,xyz,2034-11-25
5497,4469,1028,2005,11,26,xyz,2034-11-26
8892,9840,-948,2005,11,27,xyz,2034-11-27
3773,3070,703,2005,11,28,xyz,2034-11-28
8267,4336,3931,2005,11,29,xyz,2034-11-29
7523,4755,2768,2005,11,30,xyz,2034-11-30
5251,3134,2117,2005,12,1,xyz,2034-12-01
5179,1213,3966,2005,12,2,xyz,2034-12-02
2498,3126,-628,2005,12,3,xyz,2034-12-03
9168,4288,4880,2005,12,4,xyz,2034-12-04
6465,8060,-1595,2005,12,5,xyz,2034-12-05
9634,4333,5301,2005,12,6,xyz,2034-12-06
1636,1109,527,2005,12,7,xyz,2034-12-07
4959,5121,-162,2005,12,8,xyz,2034-12-08
3101,4526,-1425,2005,12,9,xyz,2034-12-09
2311,9923,-7612,2005,12,10,xyz,2034-12-10
6653,2188,4465,2005,12,11,xyz,2034-12-11
9002,8983,19,2005,12,12,xyz,2034-12-12
8152,8475,-323,2005,12,13,xyz,2034-12-13
5730,2816,2914,2005,12,14,xyz,2034-12-14
1912,3849,-1937,2005,12,15,xyz,2034-12-15
9377,9619,-242,2005,12,16,xyz,2034-12-16
8179,9875,-1696,2005,12,17,xyz,2034-12-17
5147,6627,-1480,2005,12,18,xyz,2034-12-18
1317,4669,-3352,2005,12,19,xyz,2034-12-19
7677,8838,-1161,2005,12,20,xyz,2034-12-20
9750,1088,8662,2005,12,21,xyz,2034-12-21
3133,7493,-4360,2005,12,22,xyz,2034-12-22
6734,676,6058,2005,12,23,xyz,2034-12-23
7146,6897,249,2005,12,24,xyz,2034-12-24
4475,3313,1162,2005,12,25,xyz,2034-12-25
5060,8296,-3236,2005,12,26,xyz,2034-12-26
2758,9383,-6625,2005,12,27,xyz,2034-12-27
2493,2618,-125,2005,12,28,xyz,2034-12-28
4623,5247,-624,2005,12,29,xyz,2034-12-29
3024,9660,-6636,2005,12,30,xyz,2034-12-30
1285,7003,-5718,2005,12,31,xyz,2034-12-31
9235,3788,5447,2006,1,1,xyz,2035-01-01
5236,1773,3463,2006,1,2,xyz,2035-01-02
1459,955,504,2006,1,3,xyz,2035-01-03
2832,3886,-1054,2006,1,4,xyz,2035-01-04
9406,3767,5639,2006,1,5,xyz,2035-01-05
8562,9807,-1245,2006,1,6,xyz,2035-01-06
2902,7562,-4660,2006,1,7,xyz,2035-01-07
3429,3700,-271,2006,1,8,xyz,2035-01-08
6578,6106,472,2006,1,9,xyz,2035-01-09
9088,7100,1988,2006,1,10,xyz,2035-01-10
2477,4074,-1597,2006,1,11,xyz,2035-01-11
6084,2761,3323,2006,1,12,xyz,2035-01-12
4450,5285,-835,2006,1,13,xyz,2035-01-13
5815,5168,647,2006,1,14,xyz,2035-01-14
4374,504,3870,2006,1,15,xyz,2035-01-15
5139,9148,-4009,2006,1,16,xyz,2035-01-16
4046,7491,-3445,2006,1,17,xyz,2035-01-17
5415,1834,3581,2006,1,18,xyz,2035-01-18
6767,1093,5674,2006,1,19,xyz,2035-01-19
4589,6553,-1964,2006,1,20,xyz,2035-01-20
1110,5029,-3919,2006,1,21,xyz,2035-01-21
2027,2350,-323,2006,1,22,xyz,2035-01-22
7882,1954,5928,2006,1,23,xyz,2035-01-23
5646,6052,-406,2006,1,24,xyz,2035-01-24
7989,7587,402,2006,1,25,xyz,2035-01-25
8632,3207,5425,2006,1,26,xyz,2035-01-26
8825,9396,-571,2006,1,27,xyz,2035-01-27
1976,8122,-6146,2006,1,28,xyz,2035-01-28
8306,8555,-249,2006,1,29,xyz,2035-01-29
7593,4108,3485,2006,1,30,xyz,2035-01-30
5337,9924,-4587,2006,1,31,xyz,2035-01-31
4197,4185,12,2006,2,1,xyz,2035-02-01
8661,1099,7562,2006,2,2,xyz,2035-02-02
1002,6749,-5747,2006,2,3,xyz,2035-02-03
8577,9584,-1007,2006,2,4,xyz,2035-02-04
1223,3101,-1878,2006,2,5,xyz,2035-02-05
5635,2537,3098,2006,2,6,xyz,2035-02-06
2515,5886,-3371,2006,2,7,xyz,2035-02-07
8883,8715,168,2006,2,8,xyz,2035-02-08
1842,5901,-4059,2006,2,9,xyz,2035-02-09
9504,2897,6607,2006,2,10,xyz,2035-02-10
8761,8936,-175,2006,2,11,xyz,2035-02-11
6003,3879,2124,2006,2,12,xyz,2035-02-12
8975,7298,1677,2006,2,13,xyz,2035-02-13
7674,6900,774,2006,2,14,xyz,2035-02-14
3134,6382,-3248,2006,2,15,xyz,2035-02-15
2323,1924,399,2006,2,16,xyz,2035-02-16
4736,8765,-4029,2006,2,17,xyz,2035-02-17
5859,2006,3853,2006,2,18,xyz,2035-02-18
4684,3592,1092,2006,2,19,xyz,2035-02-19
9755,3797,5958,2006,2,20,xyz,2035-02-20
7252,1867,5385,2006,2,21,xyz,2035-02-21
2884,1328,1556,2006,2,22,xyz,2035-02-22
7164,9097,-1933,2006,2,23,xyz,2035-02-23
6179,5634,545,2006,2,24,xyz,2035-02-24
8254,4569,3685,2006,2,25,xyz,2035-02-25
9000,5078,3922,2006,2,26,xyz,2035-02-26
6110,5773,337,2006,2,27,xyz,2035-02-27
5493,5588,-95,2006,2,28,xyz,2035-02-28
3072,7746,-4674,2006,3,1,xyz,2035-03-01
7033,8173,-1140,2006,3,2,xyz,2035-03-02
1554,3591,-2037,2006,3,3,xyz,2035-03-03
1837,9497,-7660,2006,3,4,xyz,2035-03-04
3400,7461,-4061,2006,3,5,xyz,2035-03-05
6416,2301,4115,2006,3,6,xyz,2035-03-06
4086,7619,-3533,2006,3,7,xyz,2035-03-07
4407,9102,-4695,2006,3,8,xyz,2035-03-08
8516,4104,4412,2006,3,9,xyz,2035-03-09
6294,7621,-1327,2006,3,10,xyz,2035-03-10
2064,9796,-7732,2006,3,11,xyz,2035-03-11
6662,4278,2384,2006,3,12,xyz,2035-03-12
2860,4117,-1257,2006,3,13,xyz,2035-03-13
3952,2850,1102,2006,3,14,xyz,2035-03-14
5775,1033,4742,2006,3,15,xyz,2035-03-15
4662,3258,1404,2006,3,16,xyz,2035-03-16
6648,2268,4380,2006,3,17,xyz,2035-03-17
1426,2946,-1520,2006,3,18,xyz,2035-03-18
4442,5985,-1543,2006,3,19,xyz,2035-03-19
6135,4203,1932,2006,3,20,xyz,2035-03-20
9707,3841,5866,2006,3,21,xyz,2035-03-21
4962,2429,2533,2006,3,22,xyz,2035-03-22
7495,7934,-439,2006,3,23,xyz,2035-03-23
4389,8766,-4377,2006,3,24,xyz,2035-03-24
7467,903,6564,2006,3,25,xyz,2035-03-25
2031,4125,-2094,2006,3,26,xyz,2035-03-26
3749,4633,-884,2006,3,27,xyz,2035-03-27
6346,7905,-1559,2006,3,28,xyz,2035-03-28
7068,6647,421,2006,3,29,xyz,2035-03-29
4529,1729,2800,2006,3,30,xyz,2035-03-30
4250,1794,2456,2006,3,31,xyz,2035-03-31
1986,2503,-517,2006,4,1,xyz,2035-04-01
7591,9111,-1520,2006,4,2,xyz,2035-04-02
5649,7846,-2197,2006,4,3,xyz,2035-04-03
9961,7596,2365,2006,4,4,xyz,2035-04-04
1834,7925,-6091,2006,4,5,xyz,2035-04-05
8451,4889,3562,2006,4,6,xyz,2035-04-06
7625,3070,4555,2006,4,7,xyz,2035-04-07
8506,3889,4617,2006,4,8,xyz,2035-04-08
4660,7939,-3279,2006,4,9,xyz,2035-04-09
4219,4927,-708,2006,4,10,xyz,2035-04-10
3240,2453,787,2006,4,11,xyz,2035-04-11
9909,2071,7838,2006,4,12,xyz,2035-04-12
1972,599,1373,2006,4,13,xyz,2035-04-13
9890,8451,1439,2006,4,14,xyz,2035-04-14
6889,7482,-593,2006,4,15,xyz,2035-04-15
5518,2539,2979,2006,4,16,xyz,2035-04-16
8180,1266,6914,2006,4,17,xyz,2035-04-17
4649,3585,1064,2006,4,18,xyz,2035-04-18
4573,8356,-3783,2006,4,19,xyz,2035-04-19
6693,7827,-1134,2006,4,20,xyz,2035-04-20
2119,1271,848,2006,4,21,xyz,2035-04-21
8404,2259,6145,2006,4,22,xyz,2035-04-22
3055,1930,1125,2006,4,23,xyz,2035-04-23
9677,7971,1706,2006,4,24,xyz,2035-04-24
4294,9364,-5070,2006,4,25,xyz,2035-04-25
2236,5698,-3462,2006,4,26,xyz,2035-04-26
1660,1155,505,2006,4,27,xyz,2035-04-27
4174,8079,-3905,2006,4,28,xyz,2035-04-28
2860,3723,-863,2006,4,29,xyz,2035-04-29
1193,5021,-3828,2006,4,30,xyz,2035-04-30
3092,5759,-2667,2006,5,1,xyz,2035-05-01
7555,886,6669,2006,5,2,xyz,2035-05-02
7825,2435,5390,2006,5,3,xyz,2035-05-03
7422,6315,1107,2006,5,4,xyz,2035-05-04
5866,2915,2951,2006,5,5,xyz,2035-05-05
5940,6379,-439,2006,5,6,xyz,2035-05-06
1087,3091,-2004,2006,5,7,xyz,2035-05-07
9240,4802,4438,2006,5,8,xyz,2035-05-08
9392,5438,3954,2006,5,9,xyz,2035-05-09
6055,9780,-3725,2006,5,10,xyz,2035-05-10
5209,8546,-3337,2006,5,11,xyz,2035-05-11
7824,9200,-1376,2006,5,12,xyz,2035-05-12
4676,7665,-2989,2006,5,13,xyz,2035-05-13
4662,2302,2360,2006,5,14,xyz,2035-05-14
8519,3546,4973,2006,5,15,xyz,2035-05-15
1339,4065,-2726,2006,5,16,xyz,2035-05-16
4118,559,3559,2006,5,17,xyz,2035-05-17
1420,6240,-4820,2006,5,18,xyz,2035-05-18
7002,8858,-1856,2006,5,19,xyz,2035-05-19
7064,9624,-2560,2006,5,20,xyz,2035-05-20
7971,1233,6738,2006,5,21,xyz,2035-05-21
6423,7797,-1374,2006,5,22,xyz,2035-05-22
6821,4003,2818,2006,5,23,xyz,2035-05-23
8297,3965,4332,2006,5,24,xyz,2035-05-24
7414,2053,5361,2006,5,25,xyz,2035-05-25
5426,4288,1138,2006,5,26,xyz,2035-05-26
4055,1493,2562,2006,5,27,xyz,2035-05-27
2083,9266,-7183,2006,5,28,xyz,2035-05-28
7518,2998,4520,2006,5,29,xyz,2035-05-29
5017,4885,132,2006,5,30,xyz,2035-05-30
1958,8780,-6822,2006,5,31,xyz,2035-05-31
7204,2492,4712,2006,6,1,xyz,2035-06-01
4960,9488,-4528,2006,6,2,xyz,2035-06-02
7185,5375,1810,2006,6,3,xyz,2035-06-03
9166,6888,2278,2006,6,4,xyz,2035-06-04
1246,4316,-3070,2006,6,5,xyz,2035-06-05
1235,3647,-2412,2006,6,6,xyz,2035-06-06
9050,7593,1457,2006,6,7,xyz,2035-06-07
3773,3099,674,2006,6,8,xyz,2035-06-08
2290,6657,-4367,2006,6,9,xyz,2035-06-09
8778,8642,136,2006,6,10,xyz,2035-06-10
2957,6585,-3628,2006,6,11,xyz,2035-06-11
8053,7047,1006,2006,6,12,xyz,2035-06-12
8606,5374,3232,2006,6,13,xyz,2035-06-13
5573,3984,1589,2006,6,14,xyz,2035-06-14
2976,7471,-4495,2006,6,15,xyz,2035-06-15
1137,4539,-3402,2006,6,16,xyz,2035-06-16
9554,504,9050,2006,6,17,xyz,2035-06-17
1534,8326,-6792,2006,6,18,xyz,2035-06-18
9378,2857,6521,2006,6,19,xyz,2035-06-19
4891,9954,-5063,2006,6,20,xyz,2035-06-20
4033,5878,-1845,2006,6,21,xyz,2035-06-21
2053,982,1071,2006,6,22,xyz,2035-06-22
4534,5688,-1154,2006,6,23,xyz,2035-06-23
8334,886,7448,2006,6,24,xyz,2035-06-24
7803,9003,-1200,2006,6,25,xyz,2035-06-25
9826,7536,2290,2006,6,26,xyz,2035-06-26
1546,1923,-377,2006,6,27,xyz,2035-06-27
2815,4640,-1825,2006,6,28,xyz,2035-06-28
6901,3456,3445,2006,6,29,xyz,2035-06-29
3982,8964,-4982,2006,6,30,xyz,2035-06-30
7978,7532,446,2006,7,1,xyz,2035-07-01
8652,5450,3202,2006,7,2,xyz,2035-07-02
8460,1719,6741,2006,7,3,xyz,2035-07-03
2399,990,1409,2006,7,4,xyz,2035-07-04
5757,7174,-1417,2006,7,5,xyz,2035-07-05
6447,8181,-1734,2006,7,6,xyz,2035-07-06
4896,4403,493,2006,7,7,xyz,2035-07-07
4611,1525,3086,2006,7,8,xyz,2035-07-08
3859,5580,-1721,2006,7,9,xyz,2035-07-09
3095,6426,-3331,2006,7,10,xyz,2035-07-10
4695,8838,-4143,2006,7,11,xyz,2035-07-11
2687,2892,-205,2006,7,12,xyz,2035-07-12
1125,5474,-4349,2006,7,13,xyz,2035-07-13
8756,9892,-1136,2006,7,14,xyz,2035-07-14
8873,1732,7141,2006,7,15,xyz,2035-07-15
8560,2766,5794,2006,7,16,xyz,2035-07-16
1275,1847,-572,2006,7,17,xyz,2035-07-17
2621,4331,-1710,2006,7,18,xyz,2035-07-18
7257,4158,3099,2006,7,19,xyz,2035-07-19
2022,1314,708,2006,7,20,xyz,2035-07-20
3616,8631,-5015,2006,7,21,xyz,2035-07-21
2195,4791,-2596,2006,7,22,xyz,2035-07-22
4577,2897,1680,2006,7,23,xyz,2035-07-23
3471,1750,1721,2006,7,24,xyz,2035-07-24
8546,7257,1289,2006,7,25,xyz,2035-07-25
2960,843,2117,2006,7,26,xyz,2035-07-26
9849,2445,7404,2006,7,27,xyz,2035-07-27
2741,8792,-6051,2006,7,28,xyz,2035-07-28
1698,814,884,2006,7,29,xyz,2035-07-29
4975,7200,-2225,2006,7,30,xyz,2035-07-30
3628,2249,1379,2006,7,31,xyz,2035-07-31
5242,5937,-695,2006,8,1,xyz,2035-08-01
3430,8876,-5446,2006,8,2,xyz,2035-08-02
1076,2344,-1268,2006,8,3,xyz,2035-08-03
3556,8835,-5279,2006,8,4,xyz,2035-08-04
9133,6503,2630,2006,8,5,xyz,2035-08-05
3924,4944,-1020,2006,8,6,xyz,2035-08-06
2641,8126,-5485,2006,8,7,xyz,2035-08-07
5556,6225,-669,2006,8,8,xyz,2035-08-08
3324,3896,-572,2006,8,9,xyz,2035-08-09
2152,7630,-5478,2006,8,10,xyz,2035-08-10
9712,7468,2244,2006,8,11,xyz,2035-08-11
9335,3314,6021,2006,8,12,xyz,2035-08-12
5241,2245,2996,2006,8,13,xyz,2035-08-13
9138,1211,7927,2006,8,14,xyz,2035-08-14
6687,1913,4774,2006,8,15,xyz,2035-08-15
6396,8728,-2332,2006,8,16,xyz,2035-08-16
2175,4127,-1952,2006,8,17,xyz,2035-08-17
2115,6476,-4361,2006,8,18,xyz,2035-08-18
9147,4709,4438,2006,8,19,xyz,2035-08-19
1604,1199,405,2006,8,20,xyz,2035-08-20
2982,2583,399,2006,8,21,xyz,2035-08-21
5056,3195,1861,2006,8,22,xyz,2035-08-22
2286,6064,-3778,2006,8,23,xyz,2035-08-23
2565,2245,320,2006,8,24,xyz,2035-08-24
4098,3635,463,2006,8,25,xyz,2035-08-25
5577,4604,973,2006,8,26,xyz,2035-08-26
8491,5275,3216,2006,8,27,xyz,2035-08-27
1022,8758,-7736,2006,8,28,xyz,2035-08-28
9853,7658,2195,2006,8,29,xyz,2035-08-29
4308,8032,-3724,2006,8,30,xyz,2035-08-30
1443,4795,-3352,2006,8,31,xyz,2035-08-31
1557,6297,-4740,2006,9,1,xyz,2035-09-01
7635,4547,3088,2006,9,2,xyz,2035-09-02
5086,2077,3009,2006,9,3,xyz,2035-09-03
8770,8521,249,2006,9,4,xyz,2035-09-04
3720,3959,-239,2006,9,5,xyz,2035-09-05
5021,4219,802,2006,9,6,xyz,2035-09-06
1017,1926,-909,2006,9,7,xyz,2035-09-07
6609,6471,138,2006,9,8,xyz,2035-09-08
9915,3927,5988,2006,9,9,xyz,2035-09-09
7998,7933,65,2006,9,10,xyz,2035-09-10
9471,2882,6589,2006,9,11,xyz,2035-09-11
6791,7623,-832,2006,9,12,xyz,2035-09-12
4388,6643,-2255,2006,9,13,xyz,2035-09-13
1490,6443,-4953,2006,9,14,xyz,2035-09-14
8736,1745,6991,2006,9,15,xyz,2035-09-15
8473,1524,6949,2006,9,16,xyz,2035-09-16
5460,1980,3480,2006,9,17,xyz,2035-09-17
7607,2239,5368,2006,9,18,xyz,2035-09-18
8283,3355,4928,2006,9,19,xyz,2035-09-19
4501,539,3962,2006,9,20,xyz,2035-09-20
8676,9652,-976,2006,9,21,xyz,2035-09-21
5770,8471,-2701,2006,9,22,xyz,2035-09-22
1518,4797,-3279,2006,9,23,xyz,2035-09-23
4197,4893,-696,2006,9,24,xyz,2035-09-24
2628,4206,-1578,2006,9,25,xyz,2035-09-25
3895,3135,760,2006,9,26,xyz,2035-09-26
9870,9783,87,2006,9,27,xyz,2035-09-27
1035,3797,-2762,2006,9,28,xyz,2035-09-28
1615,5458,-3843,2006,9,29,xyz,2035-09-29
2396,1493,903,2006,9,30,xyz,2035-09-30
1014,5635,-4621,2006,10,1,xyz,2035-10-01
1032,8060,-7028,2006,10,2,xyz,2035-10-02
3737,2938,799,2006,10,3,xyz,2035-10-03
7071,1041,6030,2006,10,4,xyz,2035-10-04
3283,599,2684,2006,10,5,xyz,2035-10-05
7168,7176,-8,2006,10,6,xyz,2035-10-06
8539,9606,-1067,2006,10,7,xyz,2035-10-07
8137,8955,-818,2006,10,8,xyz,2035-10-08
5945,6897,-952,2006,10,9,xyz,2035-10-09
7645,9421,-1776,2006,10,10,xyz,2035-10-10
7877,3735,4142,2006,10,11,xyz,2035-10-11
3346,1776,1570,2006,10,12,xyz,2035-10-12
2221,2249,-28,2006,10,13,xyz,2035-10-13
4201,9108,-4907,2006,10,14,xyz,2035-10-14
5039,3698,1341,2006,10,15,xyz,2035-10-15
7869,2753,5116,2006,10,16,xyz,2035-10-16
9999,5444,4555,2006,10,17,xyz,2035-10-17
2938,8652,-5714,2006,10,18,xyz,2035-10-18
7376,3873,3503,2006,10,19,xyz,2035-10-19
6083,8003,-1920,2006,10,20,xyz,2035-10-20
9511,5517,3994,2006,10,21,xyz,2035-10-21
4996,8939,-3943,2006,10,22,xyz,2035-10-22
8292,3616,4676,2006,10,23,xyz,2035-10-23
3911,1715,2196,2006,10,24,xyz,2035-10-24
5541,988,4553,2006,10,25,xyz,2035-10-25
9066,2684,6382,2006,10,26,xyz,2035-10-26
7691,2390,5301,2006,10,27,xyz,2035-10-27
1949,3034,-1085,2006,10,28,xyz,2035-10-28
4904,4811,93,2006,10,29,xyz,2035-10-29
1025,2839,-1814,2006,10,30,xyz,2035-10-30
5985,4059,1926,2006,10,31,xyz,2035-10-31
7068,1752,5316,2006,11,1,xyz,2035-11-01
8473,5815,2658,2006,11,2,xyz,2035-11-02
6428,4361,2067,2006,11,3,xyz,2035-11-03
2821,9525,-6704,2006,11,4,xyz,2035-11-04
9387,1538,7849,2006,11,5,xyz,2035-11-05
9158,2129,7029,2006,11,6,xyz,2035-11-06
6190,9329,-3139,2006,11,7,xyz,2035-11-07
3246,2156,1090,2006,11,8,xyz,2035-11-08
5542,2459,3083,2006,11,9,xyz,2035-11-09
2583,1615,968,2006,11,10,xyz,2035-11-10
1361,4615,-3254,2006,11,11,xyz,2035-11-11
5704,2599,3105,2006,11,12,xyz,2035-11-12
3089,8573,-5484,2006,11,13,xyz,2035-11-13
9534,8082,1452,2006,11,14,xyz,2035-11-14
8330,594,7736,2006,11,15,xyz,2035-11-15
4866,9500,-4634,2006,11,16,xyz,2035-11-16
6117,8535,-2418,2006,11,17,xyz,2035-11-17
7361,1761,5600,2006,11,18,xyz,2035-11-18
9382,2094,7288,2006,11,19,xyz,2035-11-19
9607,4191,5416,2006,11,20,xyz,2035-11-20
1973,8546,-6573,2006,11,21,xyz,2035-11-21
3686,1393,2293,2006,11,22,xyz,2035-11-22
5842,8275,-2433,2006,11,23,xyz,2035-11-23
2660,5949,-3289,2006,11,24,xyz,2035-11-24
6436,8821,-2385,2006,11,25,xyz,2035-11-25
5948,9270,-3322,2006,11,26,xyz,2035-11-26
6230,5701,529,2006,11,27,xyz,2035-11-27
5164,5047,117,2006,11,28,xyz,2035-11-28
3890,4512,-622,2006,11,29,xyz,2035-11-29
5697,1443,4254,2006,11,30,xyz,2035-11-30
9438,7690,1748,2006,12,1,xyz,2035-12-01
5503,7699,-2196,2006,12,2,xyz,2035-12-02
4922,3322,1600,2006,12,3,xyz,2035-12-03
2193,5135,-2942,2006,12,4,xyz,2035-12-04
4399,8286,-3887,2006,12,5,xyz,2035-12-05
7350,4159,3191,2006,12,6,xyz,2035-12-06
7047,3841,3206,2006,12,7,xyz,2035-12-07
8055,2530,5525,2006,12,8,xyz,2035-12-08
2321,3257,-936,2006,12,9,xyz,2035-12-09
1548,9518,-7970,2006,12,10,xyz,2035-12-10
6460,1577,4883,2006,12,11,xyz,2035-12-11
1760,1563,197,2006,12,12,xyz,2035-12-12
4662,3898,764,2006,12,13,xyz,2035-12-13
8283,2937,5346,2006,12,14,xyz,2035-12-14
3216,3812,-596,2006,12,15,xyz,2035-12-15
7860,4925,2935,2006,12,16,xyz,2035-12-16
5785,4171,1614,2006,12,17,xyz,2035-12-17
5338,4044,1294,2006,12,18,xyz,2035-12-18
9418,1716,7702,2006,12,19,xyz,2035-12-19
9486,4560,4926,2006,12,20,xyz,2035-12-20
3927,2057,1870,2006,12,21,xyz,2035-12-21
8478,3636,4842,2006,12,22,xyz,2035-12-22
3757,5891,-2134,2006,12,23,xyz,2035-12-23
2641,1736,905,2006,12,24,xyz,2035-12-24
4912,6932,-2020,2006,12,25,xyz,2035-12-25
4286,4178,108,2006,12,26,xyz,2035-12-26
9360,8716,644,2006,12,27,xyz,2035-12-27
8350,8288,62,2006,12,28,xyz,2035-12-28
3375,9631,-6256,2006,12,29,xyz,2035-12-29
1154,3117,-1963,2006,12,30,xyz,2035-12-30
5244,1703,3541,2006,12,31,xyz,2035-12-31
6553,7812,-1259,2007,1,1,xyz,2036-01-01
8792,9879,-1087,2007,1,2,xyz,2036-01-02
7021,8392,-1371,2007,1,3,xyz,2036-01-03
7632,765,6867,2007,1,4,xyz,2036-01-04
8114,9359,-1245,2007,1,5,xyz,2036-01-05
8792,6780,2012,2007,1,6,xyz,2036-01-06
8905,6301,2604,2007,1,7,xyz,2036-01-07
3739,8930,-5191,2007,1,8,xyz,2036-01-08
7067,2937,4130,2007,1,9,xyz,2036-01-09
3996,2679,1317,2007,1,10,xyz,2036-01-10
5850,4095,1755,2007,1,11,xyz,2036-01-11
3366,3645,-279,2007,1,12,xyz,2036-01-12
8636,9054,-418,2007,1,13,xyz,2036-01-13
4593,4385,208,2007,1,14,xyz,2036-01-14
2390,3130,-740,2007,1,15,xyz,2036-01-15
7330,608,6722,2007,1,16,xyz,2036-01-16
6222,2106,4116,2007,1,17,xyz,2036-01-17
9866,1159,8707,2007,1,18,xyz,2036-01-18
1530,6963,-5433,2007,1,19,xyz,2036-01-19
5679,1275,4404,2007,1,20,xyz,2036-01-20
6199,3314,2885,2007,1,21,xyz,2036-01-21
4404,6392,-1988,2007,1,22,xyz,2036-01-22
6111,6457,-346,2007,1,23,xyz,2036-01-23
4014,673,3341,2007,1,24,xyz,2036-01-24
1834,8708,-6874,2007,1,25,xyz,2036-01-25
8946,2500,6446,2007,1,26,xyz,2036-01-26
2484,5458,-2974,2007,1,27,xyz,2036-01-27
3790,7205,-3415,2007,1,28,xyz,2036-01-28
8025,3025,5000,2007,1,29,xyz,2036-01-29
6548,6244,304,2007,1,30,xyz,2036-01-30
9812,8316,1496,2007,1,31,xyz,2036-01-31
8249,5515,2734,2007,2,1,xyz,2036-02-01
8218,6702,1516,2007,2,2,xyz,2036-02-02
6750,3643,3107,2007,2,3,xyz,2036-02-03
9215,1543,7672,2007,2,4,xyz,2036-02-04
4640,7177,-2537,2007,2,5,xyz,2036-02-05
2929,4543,-1614,2007,2,6,xyz,2036-02-06
4349,6073,-1724,2007,2,7,xyz,2036-02-07
8393,1900,6493,2007,2,8,xyz,2036-02-08
4751,6079,-1328,2007,2,9,xyz,2036-02-09
6482,6975,-493,2007,2,10,xyz,2036-02-10
7937,7801,136,2007,2,11,xyz,2036-02-11
6826,566,6260,2007,2,12,xyz,2036-02-12
6834,7804,-970,2007,2,13,xyz,2036-02-13
9362,8397,965,2007,2,14,xyz,2036-02-14
1375,5875,-4500,2007,2,15,xyz,2036-02-15
8469,8684,-215,2007,2,16,xyz,2036-02-16
5548,2991,2557,2007,2,17,xyz,2036-02-17
8036,1231,6805,2007,2,18,xyz,2036-02-18
4258,3830,428,2007,2,19,xyz,2036-02-19
6148,6732,-584,2007,2,20,xyz,2036-02-20
4763,822,3941,2007,2,21,xyz,2036-02-21
3832,4120,-288,2007,2,22,xyz,2036-02-22
7400,6591,809,2007,2,23,xyz,2036-02-23
9886,2662,7224,2007,2,24,xyz,2036-02-24
4193,6569,-2376,2007,2,25,xyz,2036-02-25
8886,7461,1425,2007,2,26,xyz,2036-02-26
7478,6039,1439,2007,2,27,xyz,2036-02-27
6745,677,6068,2007,2,28,xyz,2036-02-28
7443,1365,6078,2007,2,29,xyz,2036-02-29
5743,4693,1050,2007,3,1,xyz,2036-03-01
5708,5178,530,2007,3,2,xyz,2036-03-02
9138,1373,7765,2007,3,3,xyz,2036-03-03
6464,8523,-2059,2007,3,4,xyz,2036-03-04
9536,6552,2984,2007,3,5,xyz,2036-03-05
3633,948,2685,2007,3,6,xyz,2036-03-06
2644,7477,-4833,2007,3,7,xyz,2036-03-07
4671,6629,-1958,2007,3,8,xyz,2036-03-08
9509,7553,1956,2007,3,9,xyz,2036-03-09
2682,3450,-768,2007,3,10,xyz,2036-03-10
2376,6557,-4181,2007,3,11,xyz,2036-03-11
9465,8844,621,2007,3,12,xyz,2036-03-12
9872,795,9077,2007,3,13,xyz,2036-03-13
7817,6329,1488,2007,3,14,xyz,2036-03-14
6561,6216,345,2007,3,15,xyz,2036-03-15
4045,2398,1647,2007,3,16,xyz,2036-03-16
3157,8357,-5200,2007,3,17,xyz,2036-03-17
1943,1935,8,2007,3,18,xyz,2036-03-18
7855,658,7197,2007,3,19,xyz,2036-03-19
4449,9689,-5240,2007,3,20,xyz,2036-03-20
6286,9757,-3471,2007,3,21,xyz,2036-03-21
1927,9690,-7763,2007,3,22,xyz,2036-03-22
8753,5988,2765,2007,3,23,xyz,2036-03-23
6611,6469,142,2007,3,24,xyz,2036-03-24
7218,3995,3223,2007,3,25,xyz,2036-03-25
2488,2024,464,2007,3,26,xyz,2036-03-26
5879,6396,-517,2007,3,27,xyz,2036-03-27
4852,2714,2138,2007,3,28,xyz,2036-03-28
2172,9374,-7202,2007,3,29,xyz,2036-03-29
7301,6891,410,2007,3,30,xyz,2036-03-30
7912,8725,-813,2007,3,31,xyz,2036-03-31
6474,4802,1672,2007,4,1,xyz,2036-04-01
3466,8329,-4863,2007,4,2,xyz,2036-04-02
4019,3259,760,2007,4,3,xyz,2036-04-03
1338,8154,-6816,2007,4,4,xyz,2036-04-04
8732,7163,1569,2007,4,5,xyz,2036-04-05
1785,7675,-5890,2007,4,6,xyz,2036-04-06
2582,7165,-4583,2007,4,7,xyz,2036-04-07
7423,8004,-581,2007,4,8,xyz,2036-04-08
8255,7367,888,2007,4,9,xyz,2036-04-09
9509,9373,136,2007,4,10,xyz,2036-04-10
6446,9732,-3286,2007,4,11,xyz,2036-04-11
7197,2460,4737,2007,4,12,xyz,2036-04-12
2167,3472,-1305,2007,4,13,xyz,2036-04-13
5611,3291,2320,2007,4,14,xyz,2036-04-14
7485,6212,1273,2007,4,15,xyz,2036-04-15
5368,5936,-568,2007,4,16,xyz,2036-04-16
4221,3584,637,2007,4,17,xyz,2036-04-17
9553,6144,3409,2007,4,18,xyz,2036-04-18
7384,8293,-909,2007,4,19,xyz,2036-04-19
9392,9039,353,2007,4,20,xyz,2036-04-20
4096,7494,-3398,2007,4,21,xyz,2036-04-21
3533,3899,-366,2007,4,22,xyz,2036-04-22
8577,766,7811,2007,4,23,xyz,2036-04-23
7736,892,6844,2007,4,24,xyz,2036-04-24
8394,8467,-73,2007,4,25,xyz,2036-04-25
1934,8830,-6896,2007,4,26,xyz,2036-04-26
5743,8939,-3196,2007,4,27,xyz,2036-04-27
8875,1540,7335,2007,4,28,xyz,2036-04-28
2720,9496,-6776,2007,4,29,xyz,2036-04-29
6489,2392,4097,2007,4,30,xyz,2036-04-30
6337,7930,-1593,2007,5,1,xyz,2036-05-01
9959,2371,7588,2007,5,2,xyz,2036-05-02
9717,6656,3061,2007,5,3,xyz,2036-05-03
9388,6147,3241,2007,5,4,xyz,2036-05-04
2589,9769,-7180,2007,5,5,xyz,2036-05-05
7555,9243,-1688,2007,5,6,xyz,2036-05-06
1198,7380,-6182,2007,5,7,xyz,2036-05-07
3473,8489,-5016,2007,5,8,xyz,2036-05-08
6605,3118,3487,2007,5,9,xyz,2036-05-09
6189,3176,3013,2007,5,10,xyz,2036-05-10
7575,2486,5089,2007,5,11,xyz,2036-05-11
9490,5406,4084,2007,5,12,xyz,2036-05-12
5354,1610,3744,2007,5,13,xyz,2036-05-13
7173,4896,2277,2007,5,14,xyz,2036-05-14
7605,9027,-1422,2007,5,15,xyz,2036-05-15
3441,1136,2305,2007,5,16,xyz,2036-05-16
8980,2204,6776,2007,5,17,xyz,2036-05-17
1061,1755,-694,2007,5,18,xyz,2036-05-18
4021,5152,-1131,2007,5,19,xyz,2036-05-19
6144,8697,-2553,2007,5,20,xyz,2036-05-20
3151,5914,-2763,2007,5,21,xyz,2036-05-21
3743,7618,-3875,2007,5,22,xyz,2036-05-22
4242,8037,-3795,2007,5,23,xyz,2036-05-23
6602,9793,-3191,2007,5,24,xyz,2036-05-24
3197,6797,-3600,2007,5,25,xyz,2036-05-25
1591,4869,-3278,2007,5,26,xyz,2036-05-26
1558,2328,-770,2007,5,27,xyz,2036-05-27
7654,8920,-1266,2007,5,28,xyz,2036-05-28
9678,6149,3529,2007,5,29,xyz,2036-05-29
5897,3053,2844,2007,5,30,xyz,2036-05-30
7109,6549,560,2007,5,31,xyz,2036-05-31
9670,8858,812,2007,6,1,xyz,2036-06-01
3294,7276,-3982,2007,6,2,xyz,2036-06-02
4270,5992,-1722,2007,6,3,xyz,2036-06-03
9285,8319,966,2007,6,4,xyz,2036-06-04
2212,529,1683,2007,6,5,xyz,2036-06-05
3844,3542,302,2007,6,6,xyz,2036-06-06
1670,3443,-1773,2007,6,7,xyz,2036-06-07
1415,1449,-34,2007,6,8,xyz,2036-06-08
8425,9822,-1397,2007,6,9,xyz,2036-06-09
3661,6403,-2742,2007,6,10,xyz,2036-06-10
6227,4114,2113,2007,6,11,xyz,2036-06-11
9414,4087,5327,2007,6,12,xyz,2036-06-12
6593,5234,1359,2007,6,13,xyz,2036-06-13
2087,4914,-2827,2007,6,14,xyz,2036-06-14
9458,1818,7640,2007,6,15,xyz,2036-06-15
9551,6125,3426,2007,6,16,xyz,2036-06-16
6667,4933,1734,2007,6,17,xyz,2036-06-17
1514,3768,-2254,2007,6,18,xyz,2036-06-18
8476,3306,5170,2007,6,19,xyz,2036-06-19
1882,3371,-1489,2007,6,20,xyz,2036-06-20
7663,7314,349,2007,6,21,xyz,2036-06-21
9087,5174,3913,2007,6,22,xyz,2036-06-22
3274,2562,712,2007,6,23,xyz,2036-06-23
1883,7628,-5745,2007,6,24,xyz,2036-06-24
6829,3113,3716,2007,6,25,xyz,2036-06-25
6291,2055,4236,2007,6,26,xyz,2036-06-26
4635,7549,-2914,2007,6,27,xyz,2036-06-27
8182,9274,-1092,2007,6,28,xyz,2036-06-28
2293,3664,-1371,2007,6,29,xyz,2036-06-29
4067,6429,-2362,2007,6,30,xyz,2036-06-30
8370,9667,-1297,2007,7,1,xyz,2036-07-01
8329,8002,327,2007,7,2,xyz,2036-07-02
3643,1107,2536,2007,7,3,xyz,2036-07-03
8478,1693,6785,2007,7,4,xyz,2036-07-04
7076,8287,-1211,2007,7,5,xyz,2036-07-05
9508,8720,788,2007,7,6,xyz,2036-07-06
7981,3607,4374,2007,7,7,xyz,2036-07-07
1181,4569,-3388,2007,7,8,xyz,2036-07-08
5557,2288,3269,2007,7,9,xyz,2036-07-09
7315,4193,3122,2007,7,10,xyz,2036-07-10
5967,2880,3087,2007,7,11,xyz,2036-07-11
4542,1109,3433,2007,7,12,xyz,2036-07-12
9984,4588,5396,2007,7,13,xyz,2036-07-13
6172,5645,527,2007,7,14,xyz,2036-07-14
1147,6816,-5669,2007,7,15,xyz,2036-07-15
4422,992,3430,2007,7,16,xyz,2036-07-16
4653,8313,-3660,2007,7,17,xyz,2036-07-17
1652,7808,-6156,2007,7,18,xyz,2036-07-18
7192,6953,239,2007,7,19,xyz,2036-07-19
4739,3200,1539,2007,7,20,xyz,2036-07-20
7476,4634,2842,2007,7,21,xyz,2036-07-21
4883,5330,-447,2007,7,22,xyz,2036-07-22
5341,7855,-2514,2007,7,23,xyz,2036-07-23
7714,5785,1929,2007,7,24,xyz,2036-07-24
9237,7121,2116,2007,7,25,xyz,2036-07-25
7073,8429,-1356,2007,7,26,xyz,2036-07-26
6814,3264,3550,2007,7,27,xyz,2036-07-27
7555,1075,6480,2007,7,28,xyz,2036-07-28
5984,9285,-3301,2007,7,29,xyz,2036-07-29
2952,5531,-2579,2007,7,30,xyz,2036-07-30
3068,5254,-2186,2007,7,31,xyz,2036-07-31
8012,7292,720,2007,8,1,xyz,2036-08-01
2799,9422,-6623,2007,8,2,xyz,2036-08-02
2034,1597,437,2007,8,3,xyz,2036-08-03
4444,6266,-1822,2007,8,4,xyz,2036-08-04
7803,6175,1628,2007,8,5,xyz,2036-08-05
6507,1432,5075,2007,8,6,xyz,2036-08-06
9903,7399,2504,2007,8,7,xyz,2036-08-07
3697,738,2959,2007,8,8,xyz,2036-08-08
2758,2629,129,2007,8,9,xyz,2036-08-09
9905,2320,7585,2007,8,10,xyz,2036-08-10
1727,9621,-7894,2007,8,11,xyz,2036-08-11
5610,1357,4253,2007,8,12,xyz,2036-08-12
3836,3245,591,2007,8,13,xyz,2036-08-13
5534,3797,1737,2007,8,14,xyz,2036-08-14
4750,9144,-4394,2007,8,15,xyz,2036-08-15
8639,8221,418,2007,8,16,xyz,2036-08-16
2744,7892,-5148,2007,8,17,xyz,2036-08-17
4338,6936,-2598,2007,8,18,xyz,2036-08-18
2255,8951,-6696,2007,8,19,xyz,2036-08-19
5500,8541,-3041,2007,8,20,xyz,2036-08-20
3082,8499,-5417,2007,8,21,xyz,2036-08-21
7131,4516,2615,2007,8,22,xyz,2036-08-22
4687,1446,3241,2007,8,23,xyz,2036-08-23
9222,7941,1281,2007,8,24,xyz,2036-08-24
7506,5439,2067,2007,8,25,xyz,2036-08-25
8109,9463,-1354,2007,8,26,xyz,2036-08-26
9585,6723,2862,2007,8,27,xyz,2036-08-27
6849,8923,-2074,2007,8,28,xyz,2036-08-28
7452,7105,347,2007,8,29,xyz,2036-08-29
4029,9949,-5920,2007,8,30,xyz,2036-08-30
4561,3793,768,2007,8,31,xyz,2036-08-31
3961,5825,-1864,2007,9,1,xyz,2036-09-01
3629,7533,-3904,2007,9,2,xyz,2036-09-02
3386,1499,1887,2007,9,3,xyz,2036-09-03
4736,3415,1321,2007,9,4,xyz,2036-09-04
9587,8567,1020,2007,9,5,xyz,2036-09-05
1586,5432,-3846,2007,9,6,xyz,2036-09-06
9971,5980,3991,2007,9,7,xyz,2036-09-07
3511,3189,322,2007,9,8,xyz,2036-09-08
9808,5202,4606,2007,9,9,xyz,2036-09-09
8442,2349,6093,2007,9,10,xyz,2036-09-10
5903,9591,-3688,2007,9,11,xyz,2036-09-11
1982,8453,-6471,2007,9,12,xyz,2036-09-12
9038,1133,7905,2007,9,13,xyz,2036-09-13
8975,8262,713,2007,9,14,xyz,2036-09-14
7733,8566,-833,2007,9,15,xyz,2036-09-15
4572,2283,2289,2007,9,16,xyz,2036-09-16
1785,9741,-7956,2007,9,17,xyz,2036-09-17
1407,5254,-3847,2007,9,18,xyz,2036-09-18
7115,2333,4782,2007,9,19,xyz,2036-09-19
2641,3659,-1018,2007,9,20,xyz,2036-09-20
3515,6033,-2518,2007,9,21,xyz,2036-09-21
6022,2221,3801,2007,9,22,xyz,2036-09-22
5884,9015,-3131,2007,9,23,xyz,2036-09-23
8778,1660,7118,2007,9,24,xyz,2036-09-24
6121,2437,3684,2007,9,25,xyz,2036-09-25
3626,2030,1596,2007,9,26,xyz,2036-09-26
3237,3140,97,2007,9,27,xyz,2036-09-27
8745,9829,-1084,2007,9,28,xyz,2036-09-28
4565,2988,1577,2007,9,29,xyz,2036-09-29
5701,3369,2332,2007,9,30,xyz,2036-09-30
8967,3120,5847,2007,10,1,xyz,2036-10-01
3471,8221,-4750,2007,10,2,xyz,2036-10-02
8554,2965,5589,2007,10,3,xyz,2036-10-03
6090,4801,1289,2007,10,4,xyz,2036-10-04
6139,6483,-344,2007,10,5,xyz,2036-10-05
6196,5398,798,2007,10,6,xyz,2036-10-06
2253,3568,-1315,2007,10,7,xyz,2036-10-07
7760,5583,2177,2007,10,8,xyz,2036-10-08
9469,1204,8265,2007,10,9,xyz,2036-10-09
1612,2838,-1226,2007,10,10,xyz,2036-10-10
8656,8609,47,2007,10,11,xyz,2036-10-11
5710,9359,-3649,2007,10,12,xyz,2036-10-12
9752,1164,8588,2007,10,13,xyz,2036-10-13
5614,4636,978,2007,10,14,xyz,2036-10-14
7843,6502,1341,2007,10,15,xyz,2036-10-15
2211,535,1676,2007,10,16,xyz,2036-10-16
3862,6353,-2491,2007,10,17,xyz,2036-10-17
6177,6630,-453,2007,10,18,xyz,2036-10-18
5483,1693,3790,2007,10,19,xyz,2036-10-19
6801,4022,2779,2007,10,20,xyz,2036-10-20
4163,3160,1003,2007,10,21,xyz,2036-10-21
6370,3185,3185,2007,10,22,xyz,2036-10-22
7228,8522,-1294,2007,10,23,xyz,2036-10-23
1418,8472,-7054,2007,10,24,xyz,2036-10-24
9029,2628,6401,2007,10,25,xyz,2036-10-25
3123,9652,-6529,2007,10,26,xyz,2036-10-26
6765,9082,-2317,2007,10,27,xyz,2036-10-27
2861,4830,-1969,2007,10,28,xyz,2036-10-28
4013,3593,420,2007,10,29,xyz,2036-10-29
1558,3142,-1584,2007,10,30,xyz,2036-10-30
1519,6261,-4742,2007,10,31,xyz,2036-10-31
3336,8264,-4928,2007,11,1,xyz,2036-11-01
7538,9068,-1530,2007,11,2,xyz,2036-11-02
6803,3259,3544,2007,11,3,xyz,2036-11-03
1234,3514,-2280,2007,11,4,xyz,2036-11-04
4177,4542,-365,2007,11,5,xyz,2036-11-05
1239,9627,-8388,2007,11,6,xyz,2036-11-06
1814,7185,-5371,2007,11,7,xyz,2036-11-07
8833,2609,6224,2007,11,8,xyz,2036-11-08
3554,7167,-3613,2007,11,9,xyz,2036-11-09
1966,6261,-4295,2007,11,10,xyz,2036-11-10
5689,9343,-3654,2007,11,11,xyz,2036-11-11
5564,9761,-4197,2007,11,12,xyz,2036-11-12
6668,2329,4339,2007,11,13,xyz,2036-11-13
6068,4415,1653,2007,11,14,xyz,2036-11-14
7626,7109,517,2007,11,15,xyz,2036-11-15
2753,6979,-4226,2007,11,16,xyz,2036-11-16
8023,3046,4977,2007,11,17,xyz,2036-11-17
9983,5885,4098,2007,11,18,xyz,2036-11-18
4953,3153,1800,2007,11,19,xyz,2036-11-19
5444,4565,879,2007,11,20,xyz,2036-11-20
8656,9819,-1163,2007,11,21,xyz,2036-11-21
1148,6444,-5296,2007,11,22,xyz,2036-11-22
4861,5076,-215,2007,11,23,xyz,2036-11-23
3022,1553,1469,2007,11,24,xyz,2036-11-24
9361,9620,-259,2007,11,25,xyz,2036-11-25
5457,6044,-587,2007,11,26,xyz,2036-11-26
5897,7135,-1238,2007,11,27,xyz,2036-11-27
5984,9851,-3867,2007,11,28,xyz,2036-11-28
7556,3630,3926,2007,11,29,xyz,2036-11-29
5729,9427,-3698,2007,11,30,xyz,2036-11-30
2708,8995,-6287,2007,12,1,xyz,2036-12-01
6433,2963,3470,2007,12,2,xyz,2036-12-02
5402,9681,-4279,2007,12,3,xyz,2036-12-03
7461,8023,-562,2007,12,4,xyz,2036-12-04
2584,1443,1141,2007,12,5,xyz,2036-12-05
6377,7931,-1554,2007,12,6,xyz,2036-12-06
5775,8065,-2290,2007,12,7,xyz,2036-12-07
8920,6154,2766,2007,12,8,xyz,2036-12-08
2586,1606,980,2007,12,9,xyz,2036-12-09
4584,9932,-5348,2007,12,10,xyz,2036-12-10
6153,9888,-3735,2007,12,11,xyz,2036-12-11
9165,7687,1478,2007,12,12,xyz,2036-12-12
6447,1188,5259,2007,12,13,xyz,2036-12-13
7312,7599,-287,2007,12,14,xyz,2036-12-14
3670,6638,-2968,2007,12,15,xyz,2036-12-15
4489,2237,2252,2007,12,16,xyz,2036-12-16
9219,7883,1336,2007,12,17,xyz,2036-12-17
9542,8897,645,2007,12,18,xyz,2036-12-18
8338,1744,6594,2007,12,19,xyz,2036-12-19
4906,1039,3867,2007,12,20,xyz,2036-12-20
5710,7480,-1770,2007,12,21,xyz,2036-12-21
8814,9312,-498,2007,12,22,xyz,2036-12-22
9106,6438,2668,2007,12,23,xyz,2036-12-23
8878,1501,7377,2007,12,24,xyz,2036-12-24
6399,6307,92,2007,12,25,xyz,2036-12-25
8104,5898,2206,2007,12,26,xyz,2036-12-26
5864,2649,3215,2007,12,27,xyz,2036-12-27
7301,5531,1770,2007,12,28,xyz,2036-12-28
5765,8479,-2714,2007,12,29,xyz,2036-12-29
6184,7480,-1296,2007,12,30,xyz,2036-12-30
6457,3589,2868,2007,12,31,xyz,2036-12-31
8444,1662,6782,2008,1,1,xyz,2037-01-01
6053,9188,-3135,2008,1,2,xyz,2037-01-02
5725,8593,-2868,2008,1,3,xyz,2037-01-03
2438,6747,-4309,2008,1,4,xyz,2037-01-04
3704,3442,262,2008,1,5,xyz,2037-01-05
3412,5218,-1806,2008,1,6,xyz,2037-01-06
3965,7070,-3105,2008,1,7,xyz,2037-01-07
1611,6926,-5315,2008,1,8,xyz,2037-01-08
9126,3025,6101,2008,1,9,xyz,2037-01-09
8641,3040,5601,2008,1,10,xyz,2037-01-10
4521,4193,328,2008,1,11,xyz,2037-01-11
1864,7183,-5319,2008,1,12,xyz,2037-01-12
1036,6992,-5956,2008,1,13,xyz,2037-01-13
6594,5637,957,2008,1,14,xyz,2037-01-14
4260,1766,2494,2008,1,15,xyz,2037-01-15
8772,6933,1839,2008,1,16,xyz,2037-01-16
5064,669,4395,2008,1,17,xyz,2037-01-17
6353,907,5446,2008,1,18,xyz,2037-01-18
4623,3382,1241,2008,1,19,xyz,2037-01-19
1748,4328,-2580,2008,1,20,xyz,2037-01-20
5753,6276,-523,2008,1,21,xyz,2037-01-21
1129,4935,-3806,2008,1,22,xyz,2037-01-22
2005,5939,-3934,2008,1,23,xyz,2037-01-23
9582,1038,8544,2008,1,24,xyz,2037-01-24
9459,2630,6829,2008,1,25,xyz,2037-01-25
8953,9976,-1023,2008,1,26,xyz,2037-01-26
1187,8010,-6823,2008,1,27,xyz,2037-01-27
8101,6783,1318,2008,1,28,xyz,2037-01-28
6084,2113,3971,2008,1,29,xyz,2037-01-29
6348,2890,3458,2008,1,30,xyz,2037-01-30
1923,8345,-6422,2008,1,31,xyz,2037-01-31
9945,5073,4872,2008,2,1,xyz,2037-02-01
8998,8255,743,2008,2,2,xyz,2037-02-02
6019,7854,-1835,2008,2,3,xyz,2037-02-03
4884,3984,900,2008,2,4,xyz,2037-02-04
3727,9720,-5993,2008,2,5,xyz,2037-02-05
5637,5221,416,2008,2,6,xyz,2037-02-06
4216,8458,-4242,2008,2,7,xyz,2037-02-07
2375,4075,-1700,2008,2,8,xyz,2037-02-08
9069,4103,4966,2008,2,9,xyz,2037-02-09
1786,4819,-3033,2008,2,10,xyz,2037-02-10
1905,4309,-2404,2008,2,11,xyz,2037-02-11
3161,1888,1273,2008,2,12,xyz,2037-02-12
2696,3054,-358,2008,2,13,xyz,2037-02-13
8277,7913,364,2008,2,14,xyz,2037-02-14
6886,4640,2246,2008,2,15,xyz,2037-02-15
1489,596,893,2008,2,16,xyz,2037-02-16
2534,5337,-2803,2008,2,17,xyz,2037-02-17
6916,3403,3513,2008,2,18,xyz,2037-02-18
6979,4940,2039,2008,2,19,xyz,2037-02-19
5333,1677,3656,2008,2,20,xyz,2037-02-20
1155,1412,-257,2008,2,21,xyz,2037-02-21
1442,5583,-4141,2008,2,22,xyz,2037-02-22
8741,5676,3065,2008,2,23,xyz,2037-02-23
8448,4871,3577,2008,2,24,xyz,2037-02-24
4297,4304,-7,2008,2,25,xyz,2037-02-25
4395,5600,-1205,2008,2,26,xyz,2037-02-26
5777,4319,1458,2008,2,27,xyz,2037-02-27
7619,1487,6132,2008,2,28,xyz,2037-02-28
3549,7739,-4190,2008,3,1,xyz,2037-03-01
1551,5870,-4319,2008,3,2,xyz,2037-03-02
7119,2588,4531,2008,3,3,xyz,2037-03-03
3778,2048,1730,2008,3,4,xyz,2037-03-04
1948,5286,-3338,2008,3,5,xyz,2037-03-05
2069,3579,-1510,2008,3,6,xyz,2037-03-06
7941,1681,6260,2008,3,7,xyz,2037-03-07
9976,7281,2695,2008,3,8,xyz,2037-03-08
6046,2771,3275,2008,3,9,xyz,2037-03-09
7526,3022,4504,2008,3,10,xyz,2037-03-10
5348,9708,-4360,2008,3,11,xyz,2037-03-11
8618,1884,6734,2008,3,12,xyz,2037-03-12
2452,9569,-7117,2008,3,13,xyz,2037-03-13
9403,519,8884,2008,3,14,xyz,2037-03-14
1609,7913,-6304,2008,3,15,xyz,2037-03-15
5844,9260,-3416,2008,3,16,xyz,2037-03-16
8698,4685,4013,2008,3,17,xyz,2037-03-17
7595,8877,-1282,2008,3,18,xyz,2037-03-18
2810,3697,-887,2008,3,19,xyz,2037-03-19
9816,8399,1417,2008,3,20,xyz,2037-03-20
4415,616,3799,2008,3,21,xyz,2037-03-21
9156,3628,5528,2008,3,22,xyz,2037-03-22
4245,7623,-3378,2008,3,23,xyz,2037-03-23
8355,5729,2626,2008,3,24,xyz,2037-03-24
5426,4093,1333,2008,3,25,xyz,2037-03-25
4488,7385,-2897,2008,3,26,xyz,2037-03-26
9978,8162,1816,2008,3,27,xyz,2037-03-27
6334,2301,4033,2008,3,28,xyz,2037-03-28
8444,1062,7382,2008,3,29,xyz,2037-03-29
3765,8133,-4368,2008,3,30,xyz,2037-03-30
3235,4537,-1302,2008,3,31,xyz,2037-03-31
1480,8982,-7502,2008,4,1,xyz,2037-04-01
8775,4341,4434,2008,4,2,xyz,2037-04-02
9684,8429,1255,2008,4,3,xyz,2037-04-03
5278,4086,1192,2008,4,4,xyz,2037-04-04
1860,4016,-2156,2008,4,5,xyz,2037-04-05
7951,3028,4923,2008,4,6,xyz,2037-04-06
7316,8641,-1325,2008,4,7,xyz,2037-04-07
2980,3832,-852,2008,4,8,xyz,2037-04-08
8447,6547,1900,2008,4,9,xyz,2037-04-09
3276,8706,-5430,2008,4,10,xyz,2037-04-10
3362,2185,1177,2008,4,11,xyz,2037-04-11
2429,9928,-7499,2008,4,12,xyz,2037-04-12
2854,7551,-4697,2008,4,13,xyz,2037-04-13
7946,4569,3377,2008,4,14,xyz,2037-04-14
5367,8383,-3016,2008,4,15,xyz,2037-04-15
1931,8802,-6871,2008,4,16,xyz,2037-04-16
4343,3900,443,2008,4,17,xyz,2037-04-17
3279,7261,-3982,2008,4,18,xyz,2037-04-18
8025,3078,4947,2008,4,19,xyz,2037-04-19
9316,5180,4136,2008,4,20,xyz,2037-04-20
9786,8299,1487,2008,4,21,xyz,2037-04-21
4960,2267,2693,2008,4,22,xyz,2037-04-22
6851,7196,-345,2008,4,23,xyz,2037-04-23
5273,4460,813,2008,4,24,xyz,2037-04-24
2835,2427,408,2008,4,25,xyz,2037-04-25
7083,3436,3647,2008,4,26,xyz,2037-04-26
2875,1684,1191,2008,4,27,xyz,2037-04-27
4668,9240,-4572,2008,4,28,xyz,2037-04-28
3710,1997,1713,2008,4,29,xyz,2037-04-29
4890,8177,-3287,2008,4,30,xyz,2037-04-30
2950,7440,-4490,2008,5,1,xyz,2037-05-01
5684,9387,-3703,2008,5,2,xyz,2037-05-02
6549,4166,2383,2008,5,3,xyz,2037-05-03
6758,4211,2547,2008,5,4,xyz,2037-05-04
8498,6688,1810,2008,5,5,xyz,2037-05-05
5734,1536,4198,2008,5,6,xyz,2037-05-06
7635,4040,3595,2008,5,7,xyz,2037-05-07
1235,4266,-3031,2008,5,8,xyz,2037-05-08
8608,613,7995,2008,5,9,xyz,2037-05-09
4204,1787,2417,2008,5,10,xyz,2037-05-10
8155,7288,867,2008,5,11,xyz,2037-05-11
7149,7995,-846,2008,5,12,xyz,2037-05-12
7366,4975,2391,2008,5,13,xyz,2037-05-13
9892,1550,8342,2008,5,14,xyz,2037-05-14
4212,6052,-1840,2008,5,15,xyz,2037-05-15
8150,3352,4798,2008,5,16,xyz,2037-05-16
4706,8847,-4141,2008,5,17,xyz,2037-05-17
6000,9060,-3060,2008,5,18,xyz,2037-05-18
9881,1191,8690,2008,5,19,xyz,2037-05-19
4482,9604,-5122,2008,5,20,xyz,2037-05-20
1175,9682,-8507,2008,5,21,xyz,2037-05-21
4591,701,3890,2008,5,22,xyz,2037-05-22
1724,1170,554,2008,5,23,xyz,2037-05-23
5736,2926,2810,2008,5,24,xyz,2037-05-24
7266,4455,2811,2008,5,25,xyz,2037-05-25
1015,2452,-1437,2008,5,26,xyz,2037-05-26
7052,692,6360,2008,5,27,xyz,2037-05-27
9079,8163,916,2008,5,28,xyz,2037-05-28
2387,7283,-4896,2008,5,29,xyz,2037-05-29
4708,6117,-1409,2008,5,30,xyz,2037-05-30
3153,3824,-671,2008,5,31,xyz,2037-05-31
5024,6741,-1717,2008,6,1,xyz,2037-06-01
5247,3803,1444,2008,6,2,xyz,2037-06-02
2824,5544,-2720,2008,6,3,xyz,2037-06-03
8897,4418,4479,2008,6,4,xyz,2037-06-04
4340,6838,-2498,2008,6,5,xyz,2037-06-05
8319,6003,2316,2008,6,6,xyz,2037-06-06
1336,7369,-6033,2008,6,7,xyz,2037-06-07
8127,2509,5618,2008,6,8,xyz,2037-06-08
2681,5349,-2668,2008,6,9,xyz,2037-06-09
9026,9854,-828,2008,6,10,xyz,2037-06-10
8196,3926,4270,2008,6,11,xyz,2037-06-11
2426,5743,-3317,2008,6,12,xyz,2037-06-12
1297,2507,-1210,2008,6,13,xyz,2037-06-13
5968,2577,3391,2008,6,14,xyz,2037-06-14
1333,6737,-5404,2008,6,15,xyz,2037-06-15
1980,1670,310,2008,6,16,xyz,2037-06-16
4682,5762,-1080,2008,6,17,xyz,2037-06-17
3687,2649,1038,2008,6,18,xyz,2037-06-18
8415,8373,42,2008,6,19,xyz,2037-06-19
3298,7712,-4414,2008,6,20,xyz,2037-06-20
7939,5911,2028,2008,6,21,xyz,2037-06-21
4404,3092,1312,2008,6,22,xyz,2037-06-22
5299,3428,1871,2008,6,23,xyz,2037-06-23
8945,6237,2708,2008,6,24,xyz,2037-06-24
9223,6370,2853,2008,6,25,xyz,2037-06-25
3265,6451,-3186,2008,6,26,xyz,2037-06-26
4254,4626,-372,2008,6,27,xyz,2037-06-27
9247,6233,3014,2008,6,28,xyz,2037-06-28
4136,7166,-3030,2008,6,29,xyz,2037-06-29
1855,8444,-6589,2008,6,30,xyz,2037-06-30
2559,6456,-3897,2008,7,1,xyz,2037-07-01
5913,7841,-1928,2008,7,2,xyz,2037-07-02
4771,9379,-4608,2008,7,3,xyz,2037-07-03
8690,1835,6855,2008,7,4,xyz,2037-07-04
1125,3805,-2680,2008,7,5,xyz,2037-07-05
2116,6671,-4555,2008,7,6,xyz,2037-07-06
2904,6408,-3504,2008,7,7,xyz,2037-07-07
4880,3251,1629,2008,7,8,xyz,2037-07-08
9325,2865,6460,2008,7,9,xyz,2037-07-09
6694,9220,-2526,2008,7,10,xyz,2037-07-10
4958,6478,-1520,2008,7,11,xyz,2037-07-11
2221,9363,-7142,2008,7,12,xyz,2037-07-12
8727,6845,1882,2008,7,13,xyz,2037-07-13
7553,8065,-512,2008,7,14,xyz,2037-07-14
5413,5129,284,2008,7,15,xyz,2037-07-15
5987,1966,4021,2008,7,16,xyz,2037-07-16
1143,897,246,2008,7,17,xyz,2037-07-17
9227,5388,3839,2008,7,18,xyz,2037-07-18
2671,7641,-4970,2008,7,19,xyz,2037-07-19
2672,4053,-1381,2008,7,20,xyz,2037-07-20
3099,9909,-6810,2008,7,21,xyz,2037-07-21
8382,2737,5645,2008,7,22,xyz,2037-07-22
5982,6318,-336,2008,7,23,xyz,2037-07-23
1137,3100,-1963,2008,7,24,xyz,2037-07-24
3359,5064,-1705,2008,7,25,xyz,2037-07-25
2318,5271,-2953,2008,7,26,xyz,2037-07-26
5088,9211,-4123,2008,7,27,xyz,2037-07-27
1806,2403,-597,2008,7,28,xyz,2037-07-28
1700,6419,-4719,2008,7,29,xyz,2037-07-29
7324,6246,1078,2008,7,30,xyz,2037-07-30
1474,960,514,2008,7,31,xyz,2037-07-31
3932,7217,-3285,2008,8,1,xyz,2037-08-01
3815,9466,-5651,2008,8,2,xyz,2037-08-02
8570,7427,1143,2008,8,3,xyz,2037-08-03
7744,7873,-129,2008,8,4,xyz,2037-08-04
9739,7225,2514,2008,8,5,xyz,2037-08-05
7300,4346,2954,2008,8,6,xyz,2037-08-06
1307,7803,-6496,2008,8,7,xyz,2037-08-07
2890,5273,-2383,2008,8,8,xyz,2037-08-08
2130,3015,-885,2008,8,9,xyz,2037-08-09
4945,4188,757,2008,8,10,xyz,2037-08-10
1997,2322,-325,2008,8,11,xyz,2037-08-11
1879,1431,448,2008,8,12,xyz,2037-08-12
1642,6900,-5258,2008,8,13,xyz,2037-08-13
5211,2381,2830,2008,8,14,xyz,2037-08-14
5554,4056,1498,2008,8,15,xyz,2037-08-15
9818,2525,7293,2008,8,16,xyz,2037-08-16
2736,6884,-4148,2008,8,17,xyz,2037-08-17
8624,9735,-1111,2008,8,18,xyz,2037-08-18
6473,9539,-3066,2008,8,19,xyz,2037-08-19
9796,9613,183,2008,8,20,xyz,2037-08-20
3585,3084,501,2008,8,21,xyz,2037-08-21
6504,2410,4094,2008,8,22,xyz,2037-08-22
4906,2780,2126,2008,8,23,xyz,2037-08-23
9619,8334,1285,2008,8,24,xyz,2037-08-24
9044,2330,6714,2008,8,25,xyz,2037-08-25
8019,5019,3000,2008,8,26,xyz,2037-08-26
2804,1529,1275,2008,8,27,xyz,2037-08-27
2351,5169,-2818,2008,8,28,xyz,2037-08-28
3692,2197,1495,2008,8,29,xyz,2037-08-29
1356,8092,-6736,2008,8,30,xyz,2037-08-30
8431,6920,1511,2008,8,31,xyz,2037-08-31
9756,8171,1585,2008,9,1,xyz,2037-09-01
4027,4125,-98,2008,9,2,xyz,2037-09-02
6743,2453,4290,2008,9,3,xyz,2037-09-03
9944,7536,2408,2008,9,4,xyz,2037-09-04
9049,2279,6770,2008,9,5,xyz,2037-09-05
8727,6921,1806,2008,9,6,xyz,2037-09-06
1917,4389,-2472,2008,9,7,xyz,2037-09-07
2743,1363,1380,2008,9,8,xyz,2037-09-08
4242,7938,-3696,2008,9,9,xyz,2037-09-09
5071,3737,1334,2008,9,10,xyz,2037-09-10
4264,1829,2435,2008,9,11,xyz,2037-09-11
6662,3361,3301,2008,9,12,xyz,2037-09-12
8907,8185,722,2008,9,13,xyz,2037-09-13
8399,4914,3485,2008,9,14,xyz,2037-09-14
8990,914,8076,2008,9,15,xyz,2037-09-15
6113,8493,-2380,2008,9,16,xyz,2037-09-16
7086,6618,468,2008,9,17,xyz,2037-09-17
5696,5861,-165,2008,9,18,xyz,2037-09-18
6434,5740,694,2008,9,19,xyz,2037-09-19
8814,1120,7694,2008,9,20,xyz,2037-09-20
9180,9763,-583,2008,9,21,xyz,2037-09-21
2824,7882,-5058,2008,9,22,xyz,2037-09-22
5399,4010,1389,2008,9,23,xyz,2037-09-23
4106,2994,1112,2008,9,24,xyz,2037-09-24
2370,5427,-3057,2008,9,25,xyz,2037-09-25
6893,2569,4324,2008,9,26,xyz,2037-09-26
5154,6951,-1797,2008,9,27,xyz,2037-09-27
7126,8648,-1522,2008,9,28,xyz,2037-09-28
3067,4917,-1850,2008,9,29,xyz,2037-09-29
3448,2930,518,2008,9,30,xyz,2037-09-30
4080,8670,-4590,2008,10,1,xyz,2037-10-01
6660,6840,-180,2008,10,2,xyz,2037-10-02
6934,5012,1922,2008,10,3,xyz,2037-10-03
4811,2152,2659,2008,10,4,xyz,2037-10-04
9877,4006,5871,2008,10,5,xyz,2037-10-05
7269,7818,-549,2008,10,6,xyz,2037-10-06
8457,7561,896,2008,10,7,xyz,2037-10-07
5955,3270,2685,2008,10,8,xyz,2037-10-08
9569,2655,6914,2008,10,9,xyz,2037-10-09
9391,8589,802,2008,10,10,xyz,2037-10-10
2899,8443,-5544,2008,10,11,xyz,2037-10-11
4363,5308,-945,2008,10,12,xyz,2037-10-12
7646,3950,3696,2008,10,13,xyz,2037-10-13
9921,7955,1966,2008,10,14,xyz,2037-10-14
2324,2384,-60,2008,10,15,xyz,2037-10-15
4829,1013,3816,2008,10,16,xyz,2037-10-16
1122,5559,-4437,2008,10,17,xyz,2037-10-17
3710,3561,149,2008,10,18,xyz,2037-10-18
6531,6359,172,2008,10,19,xyz,2037-10-19
7736,685,7051,2008,10,20,xyz,2037-10-20
6771,4674,2097,2008,10,21,xyz,2037-10-21
5098,626,4472,2008,10,22,xyz,2037-10-22
8561,2806,5755,2008,10,23,xyz,2037-10-23
4927,8319,-3392,2008,10,24,xyz,2037-10-24
6615,5982,633,2008,10,25,xyz,2037-10-25
6794,5458,1336,2008,10,26,xyz,2037-10-26
9398,5357,4041,2008,10,27,xyz,2037-10-27
4183,7450,-3267,2008,10,28,xyz,2037-10-28
3185,8275,-5090,2008,10,29,xyz,2037-10-29
7364,8677,-1313,2008,10,30,xyz,2037-10-30
1035,3577,-2542,2008,10,31,xyz,2037-10-31
2202,1539,663,2008,11,1,xyz,2037-11-01
5322,2365,2957,2008,11,2,xyz,2037-11-02
8534,9111,-577,2008,11,3,xyz,2037-11-03
8944,9713,-769,2008,11,4,xyz,2037-11-04
6020,8437,-2417,2008,11,5,xyz,2037-11-05
4620,1100,3520,2008,11,6,xyz,2037-11-06
5012,6490,-1478,2008,11,7,xyz,2037-11-07
8818,4784,4034,2008,11,8,xyz,2037-11-08
4352,3962,390,2008,11,9,xyz,2037-11-09
8132,6004,2128,2008,11,10,xyz,2037-11-10
5579,3361,2218,2008,11,11,xyz,2037-11-11
9155,4258,4897,2008,11,12,xyz,2037-11-12
3602,4703,-1101,2008,11,13,xyz,2037-11-13
2133,6238,-4105,2008,11,14,xyz,2037-11-14
6249,3578,2671,2008,11,15,xyz,2037-11-15
9683,4231,5452,2008,11,16,xyz,2037-11-16
2142,3083,-941,2008,11,17,xyz,2037-11-17
9661,1745,7916,2008,11,18,xyz,2037-11-18
8380,3141,5239,2008,11,19,xyz,2037-11-19
2394,3298,-904,2008,11,20,xyz,2037-11-20
6952,3153,3799,2008,11,21,xyz,2037-11-21
4206,3132,1074,2008,11,22,xyz,2037-11-22
9070,4467,4603,2008,11,23,xyz,2037-11-23
7544,2230,5314,2008,11,24,xyz,2037-11-24
1965,4381,-2416,2008,11,25,xyz,2037-11-25
7000,1472,5528,2008,11,26,xyz,2037-11-26
9948,9409,539,2008,11,27,xyz,2037-11-27
7735,7193,542,2008,11,28,xyz,2037-11-28
2255,4680,-2425,2008,11,29,xyz,2037-11-29
1035,2397,-1362,2008,11,30,xyz,2037-11-30
8325,7596,729,2008,12,1,xyz,2037-12-01
8563,6057,2506,2008,12,2,xyz,2037-12-02
9445,6596,2849,2008,12,3,xyz,2037-12-03
9708,7006,2702,2008,12,4,xyz,2037-12-04
2506,8184,-5678,2008,12,5,xyz,2037-12-05
6021,5116,905,2008,12,6,xyz,2037-12-06
8998,6425,2573,2008,12,7,xyz,2037-12-07
3358,9194,-5836,2008,12,8,xyz,2037-12-08
9526,9758,-232,2008,12,9,xyz,2037-12-09
4380,9499,-5119,2008,12,10,xyz,2037-12-10
5816,819,4997,2008,12,11,xyz,2037-12-11
5930,8473,-2543,2008,12,12,xyz,2037-12-12
2563,2564,-1,2008,12,13,xyz,2037-12-13
9446,4280,5166,2008,12,14,xyz,2037-12-14
3351,5120,-1769,2008,12,15,xyz,2037-12-15
8144,915,7229,2008,12,16,xyz,2037-12-16
6682,4962,1720,2008,12,17,xyz,2037-12-17
3882,3629,253,2008,12,18,xyz,2037-12-18
7029,2651,4378,2008,12,19,xyz,2037-12-19
7168,6386,782,2008,12,20,xyz,2037-12-20
1207,3259,-2052,2008,12,21,xyz,2037-12-21
9356,5973,3383,2008,12,22,xyz,2037-12-22
9701,5196,4505,2008,12,23,xyz,2037-12-23
7744,1774,5970,2008,12,24,xyz,2037-12-24
4377,3231,1146,2008,12,25,xyz,2037-12-25
4809,3028,1781,2008,12,26,xyz,2037-12-26
2221,1935,286,2008,12,27,xyz,2037-12-27
7179,7698,-519,2008,12,28,xyz,2037-12-28
7785,2436,5349,2008,12,29,xyz,2037-12-29
1357,1825,-468,2008,12,30,xyz,2037-12-30
2726,8282,-5556,2008,12,31,xyz,2037-12-31
2556,3821,-1265,2009,1,1,xyz,2038-01-01
5484,4143,1341,2009,1,2,xyz,2038-01-02
4449,6937,-2488,2009,1,3,xyz,2038-01-03
6643,9922,-3279,2009,1,4,xyz,2038-01-04
9847,3049,6798,2009,1,5,xyz,2038-01-05
9855,2063,7792,2009,1,6,xyz,2038-01-06
4580,9979,-5399,2009,1,7,xyz,2038-01-07
8135,6029,2106,2009,1,8,xyz,2038-01-08
9694,4822,4872,2009,1,9,xyz,2038-01-09
1072,3845,-2773,2009,1,10,xyz,2038-01-10
6325,5801,524,2009,1,11,xyz,2038-01-11
9246,5464,3782,2009,1,12,xyz,2038-01-12
9151,2751,6400,2009,1,13,xyz,2038-01-13
2070,9782,-7712,2009,1,14,xyz,2038-01-14
9798,4751,5047,2009,1,15,xyz,2038-01-15
7898,3791,4107,2009,1,16,xyz,2038-01-16
2748,3598,-850,2009,1,17,xyz,2038-01-17
1560,6206,-4646,2009,1,18,xyz,2038-01-18
7808,967,6841,2009,1,19,xyz,2038-01-19
7740,4761,2979,2009,1,20,xyz,2038-01-20
4232,1082,3150,2009,1,21,xyz,2038-01-21
3753,6771,-3018,2009,1,22,xyz,2038-01-22
9632,2759,6873,2009,1,23,xyz,2038-01-23
8370,7194,1176,2009,1,24,xyz,2038-01-24
4428,4717,-289,2009,1,25,xyz,2038-01-25
8427,2576,5851,2009,1,26,xyz,2038-01-26
8080,4229,3851,2009,1,27,xyz,2038-01-27
3297,3242,55,2009,1,28,xyz,2038-01-28
6299,637,5662,2009,1,29,xyz,2038-01-29
7403,9017,-1614,2009,1,30,xyz,2038-01-30
9694,7141,2553,2009,1,31,xyz,2038-01-31
8193,7348,845,2009,2,1,xyz,2038-02-01
8806,3405,5401,2009,2,2,xyz,2038-02-02
9825,6451,3374,2009,2,3,xyz,2038-02-03
4038,9745,-5707,2009,2,4,xyz,2038-02-04
8280,1937,6343,2009,2,5,xyz,2038-02-05
1375,4255,-2880,2009,2,6,xyz,2038-02-06
8501,3127,5374,2009,2,7,xyz,2038-02-07
2255,4108,-1853,2009,2,8,xyz,2038-02-08
2552,7575,-5023,2009,2,9,xyz,2038-02-09
2872,6763,-3891,2009,2,10,xyz,2038-02-10
1214,7685,-6471,2009,2,11,xyz,2038-02-11
6869,1131,5738,2009,2,12,xyz,2038-02-12
7584,7088,496,2009,2,13,xyz,2038-02-13
8172,5860,2312,2009,2,14,xyz,2038-02-14
6989,1932,5057,2009,2,15,xyz,2038-02-15
9798,4106,5692,2009,2,16,xyz,2038-02-16
1058,4274,-3216,2009,2,17,xyz,2038-02-17
2806,8009,-5203,2009,2,18,xyz,2038-02-18
3642,9113,-5471,2009,2,19,xyz,2038-02-19
6172,3112,3060,2009,2,20,xyz,2038-02-20
8569,5520,3049,2009,2,21,xyz,2038-02-21
3307,572,2735,2009,2,22,xyz,2038-02-22
4191,6268,-2077,2009,2,23,xyz,2038-02-23
8021,6017,2004,2009,2,24,xyz,2038-02-24
6754,2209,4545,2009,2,25,xyz,2038-02-25
2510,4393,-1883,2009,2,26,xyz,2038-02-26
8467,7543,924,2009,2,27,xyz,2038-02-27
1114,6430,-5316,2009,2,28,xyz,2038-02-28
9893,4128,5765,2009,3,1,xyz,2038-03-01
7217,3787,3430,2009,3,2,xyz,2038-03-02
3621,7304,-3683,2009,3,3,xyz,2038-03-03
9066,2326,6740,2009,3,4,xyz,2038-03-04
3933,551,3382,2009,3,5,xyz,2038-03-05
6956,3021,3935,2009,3,6,xyz,2038-03-06
1030,792,238,2009,3,7,xyz,2038-03-07
2562,6168,-3606,2009,3,8,xyz,2038-03-08
7714,5979,1735,2009,3,9,xyz,2038-03-09
9552,6286,3266,2009,3,10,xyz,2038-03-10
9479,5294,4185,2009,3,11,xyz,2038-03-11
5974,5536,438,2009,3,12,xyz,2038-03-12
4312,3706,606,2009,3,13,xyz,2038-03-13
9853,5723,4130,2009,3,14,xyz,2038-03-14
9830,736,9094,2009,3,15,xyz,2038-03-15
3561,700,2861,2009,3,16,xyz,2038-03-16
8404,4441,3963,2009,3,17,xyz,2038-03-17
4231,4528,-297,2009,3,18,xyz,2038-03-18
2715,6001,-3286,2009,3,19,xyz,2038-03-19
3826,8027,-4201,2009,3,20,xyz,2038-03-20
8610,8452,158,2009,3,21,xyz,2038-03-21
2264,3982,-1718,2009,3,22,xyz,2038-03-22
7749,4300,3449,2009,3,23,xyz,2038-03-23
1527,7889,-6362,2009,3,24,xyz,2038-03-24
2000,8761,-6761,2009,3,25,xyz,2038-03-25
5918,3182,2736,2009,3,26,xyz,2038-03-26
9936,6424,3512,2009,3,27,xyz,2038-03-27
7185,8043,-858,2009,3,28,xyz,2038-03-28
6515,2909,3606,2009,3,29,xyz,2038-03-29
2777,4113,-1336,2009,3,30,xyz,2038-03-30
4298,8020,-3722,2009,3,31,xyz,2038-03-31
7726,8154,-428,2009,4,1,xyz,2038-04-01
5682,8031,-2349,2009,4,2,xyz,2038-04-02
1689,4715,-3026,2009,4,3,xyz,2038-04-03
3150,4999,-1849,2009,4,4,xyz,2038-04-04
2620,5345,-2725,2009,4,5,xyz,2038-04-05
2949,4914,-1965,2009,4,6,xyz,2038-04-06
5682,2942,2740,2009,4,7,xyz,2038-04-07
9532,7771,1761,2009,4,8,xyz,2038-04-08
4588,1530,3058,2009,4,9,xyz,2038-04-09
8100,6562,1538,2009,4,10,xyz,2038-04-10
3063,2213,850,2009,4,11,xyz,2038-04-11
9144,7020,2124,2009,4,12,xyz,2038-04-12
5881,9752,-3871,2009,4,13,xyz,2038-04-13
1670,6567,-4897,2009,4,14,xyz,2038-04-14
9840,8337,1503,2009,4,15,xyz,2038-04-15
3080,9648,-6568,2009,4,16,xyz,2038-04-16
2387,7659,-5272,2009,4,17,xyz,2038-04-17
1120,4660,-3540,2009,4,18,xyz,2038-04-18
8390,5177,3213,2009,4,19,xyz,2038-04-19
7449,6448,1001,2009,4,20,xyz,2038-04-20
5574,9127,-3553,2009,4,21,xyz,2038-04-21
2951,5358,-2407,2009,4,22,xyz,2038-04-22
6522,9620,-3098,2009,4,23,xyz,2038-04-23
5734,5297,437,2009,4,24,xyz,2038-04-24
4786,1568,3218,2009,4,25,xyz,2038-04-25
1189,9209,-8020,2009,4,26,xyz,2038-04-26
9306,7911,1395,2009,4,27,xyz,2038-04-27
5975,1426,4549,2009,4,28,xyz,2038-04-28
5940,9916,-3976,2009,4,29,xyz,2038-04-29
8105,2079,6026,2009,4,30,xyz,2038-04-30
7883,1209,6674,2009,5,1,xyz,2038-05-01
8177,3825,4352,2009,5,2,xyz,2038-05-02
3929,5255,-1326,2009,5,3,xyz,2038-05-03
2846,9615,-6769,2009,5,4,xyz,2038-05-04
5838,9219,-3381,2009,5,5,xyz,2038-05-05
7419,3514,3905,2009,5,6,xyz,2038-05-06
3034,5294,-2260,2009,5,7,xyz,2038-05-07
7465,2270,5195,2009,5,8,xyz,2038-05-08
5666,4817,849,2009,5,9,xyz,2038-05-09
7093,1366,5727,2009,5,10,xyz,2038-05-10
6097,677,5420,2009,5,11,xyz,2038-05-11
1540,7905,-6365,2009,5,12,xyz,2038-05-12
8220,8630,-410,2009,5,13,xyz,2038-05-13
7109,1755,5354,2009,5,14,xyz,2038-05-14
8252,2917,5335,2009,5,15,xyz,2038-05-15
2512,1083,1429,2009,5,16,xyz,2038-05-16
9567,5688,3879,2009,5,17,xyz,2038-05-17
3091,9533,-6442,2009,5,18,xyz,2038-05-18
5083,5874,-791,2009,5,19,xyz,2038-05-19
9890,1895,7995,2009,5,20,xyz,2038-05-20
2071,2991,-920,2009,5,21,xyz,2038-05-21
6659,2221,4438,2009,5,22,xyz,2038-05-22
2088,6819,-4731,2009,5,23,xyz,2038-05-23
1858,3294,-1436,2009,5,24,xyz,2038-05-24
1276,3936,-2660,2009,5,25,xyz,2038-05-25
3130,5564,-2434,2009,5,26,xyz,2038-05-26
2233,5651,-3418,2009,5,27,xyz,2038-05-27
2376,3420,-1044,2009,5,28,xyz,2038-05-28
3247,6420,-3173,2009,5,29,xyz,2038-05-29
1136,7201,-6065,2009,5,30,xyz,2038-05-30
3704,1064,2640,2009,5,31,xyz,2038-05-31
2488,5407,-2919,2009,6,1,xyz,2038-06-01
6486,1895,4591,2009,6,2,xyz,2038-06-02
2175,8809,-6634,2009,6,3,xyz,2038-06-03
6205,6989,-784,2009,6,4,xyz,2038-06-04
8387,4792,3595,2009,6,5,xyz,2038-06-05
3733,8805,-5072,2009,6,6,xyz,2038-06-06
8020,6187,1833,2009,6,7,xyz,2038-06-07
4086,2162,1924,2009,6,8,xyz,2038-06-08
1877,4971,-3094,2009,6,9,xyz,2038-06-09
8567,6371,2196,2009,6,10,xyz,2038-06-10
8718,5311,3407,2009,6,11,xyz,2038-06-11
5858,1005,4853,2009,6,12,xyz,2038-06-12
7426,1657,5769,2009,6,13,xyz,2038-06-13
5223,6948,-1725,2009,6,14,xyz,2038-06-14
1154,9011,-7857,2009,6,15,xyz,2038-06-15
5964,9173,-3209,2009,6,16,xyz,2038-06-16
2027,7668,-5641,2009,6,17,xyz,2038-06-17
4694,2855,1839,2009,6,18,xyz,2038-06-18
8975,2220,6755,2009,6,19,xyz,2038-06-19
6169,7869,-1700,2009,6,20,xyz,2038-06-20
5733,8016,-2283,2009,6,21,xyz,2038-06-21
7057,3173,3884,2009,6,22,xyz,2038-06-22
1809,6085,-4276,2009,6,23,xyz,2038-06-23
6612,4231,2381,2009,6,24,xyz,2038-06-24
9854,5663,4191,2009,6,25,xyz,2038-06-25
8380,2667,5713,2009,6,26,xyz,2038-06-26
7264,4699,2565,2009,6,27,xyz,2038-06-27
2081,925,1156,2009,6,28,xyz,2038-06-28
2151,4415,-2264,2009,6,29,xyz,2038-06-29
1231,9336,-8105,2009,6,30,xyz,2038-06-30
9608,9353,255,2009,7,1,xyz,2038-07-01
4287,2188,2099,2009,7,2,xyz,2038-07-02
3861,5859,-1998,2009,7,3,xyz,2038-07-03
4970,8571,-3601,2009,7,4,xyz,2038-07-04
6152,3782,2370,2009,7,5,xyz,2038-07-05
2061,8320,-6259,2009,7,6,xyz,2038-07-06
6529,7257,-728,2009,7,7,xyz,2038-07-07
9494,3337,6157,2009,7,8,xyz,2038-07-08
5369,7990,-2621,2009,7,9,xyz,2038-07-09
1131,6441,-5310,2009,7,10,xyz,2038-07-10
1371,8444,-7073,2009,7,11,xyz,2038-07-11
8794,8526,268,2009,7,12,xyz,2038-07-12
5764,3559,2205,2009,7,13,xyz,2038-07-13
6225,2243,3982,2009,7,14,xyz,2038-07-14
2712,5422,-2710,2009,7,15,xyz,2038-07-15
4975,5624,-649,2009,7,16,xyz,2038-07-16
1663,6430,-4767,2009,7,17,xyz,2038-07-17
7213,4400,2813,2009,7,18,xyz,2038-07-18
4422,8592,-4170,2009,7,19,xyz,2038-07-19
4713,6761,-2048,2009,7,20,xyz,2038-07-20
9856,5492,4364,2009,7,21,xyz,2038-07-21
8711,3392,5319,2009,7,22,xyz,2038-07-22
2451,2533,-82,2009,7,23,xyz,2038-07-23
1549,4835,-3286,2009,7,24,xyz,2038-07-24
2416,6645,-4229,2009,7,25,xyz,2038-07-25
6327,6966,-639,2009,7,26,xyz,2038-07-26
2328,5168,-2840,2009,7,27,xyz,2038-07-27
9326,5045,4281,2009,7,28,xyz,2038-07-28
8750,3511,5239,2009,7,29,xyz,2038-07-29
3776,8260,-4484,2009,7,30,xyz,2038-07-30
9214,6291,2923,2009,7,31,xyz,2038-07-31
2636,4118,-1482,2009,8,1,xyz,2038-08-01
9577,3231,6346,2009,8,2,xyz,2038-08-02
7397,1459,5938,2009,8,3,xyz,2038-08-03
9762,8304,1458,2009,8,4,xyz,2038-08-04
6709,3111,3598,2009,8,5,xyz,2038-08-05
2005,565,1440,2009,8,6,xyz,2038-08-06
3298,7244,-3946,2009,8,7,xyz,2038-08-07
6340,3012,3328,2009,8,8,xyz,2038-08-08
9485,9963,-478,2009,8,9,xyz,2038-08-09
4068,3022,1046,2009,8,10,xyz,2038-08-10
9779,2145,7634,2009,8,11,xyz,2038-08-11
4196,6441,-2245,2009,8,12,xyz,2038-08-12
2766,2743,23,2009,8,13,xyz,2038-08-13
2908,1881,1027,2009,8,14,xyz,2038-08-14
5087,5953,-866,2009,8,15,xyz,2038-08-15
1450,2667,-1217,2009,8,16,xyz,2038-08-16
5873,8193,-2320,2009,8,17,xyz,2038-08-17
4698,1556,3142,2009,8,18,xyz,2038-08-18
6248,1004,5244,2009,8,19,xyz,2038-08-19
3504,6830,-3326,2009,8,20,xyz,2038-08-20
8493,6839,1654,2009,8,21,xyz,2038-08-21
4430,1335,3095,2009,8,22,xyz,2038-08-22
6527,5992,535,2009,8,23,xyz,2038-08-23
7686,2313,5373,2009,8,24,xyz,2038-08-24
4413,4281,132,2009,8,25,xyz,2038-08-25
6622,9353,-2731,2009,8,26,xyz,2038-08-26
9611,9574,37,2009,8,27,xyz,2038-08-27
4869,1065,3804,2009,8,28,xyz,2038-08-28
7372,8862,-1490,2009,8,29,xyz,2038-08-29
3603,922,2681,2009,8,30,xyz,2038-08-30
4224,8849,-4625,2009,8,31,xyz,2038-08-31
9334,9702,-368,2009,9,1,xyz,2038-09-01
2786,2850,-64,2009,9,2,xyz,2038-09-02
4957,8209,-3252,2009,9,3,xyz,2038-09-03
3152,6468,-3316,2009,9,4,xyz,2038-09-04
3738,5849,-2111,2009,9,5,xyz,2038-09-05
1981,2942,-961,2009,9,6,xyz,2038-09-06
9565,8257,1308,2009,9,7,xyz,2038-09-07
9261,3620,5641,2009,9,8,xyz,2038-09-08
4541,6895,-2354,2009,9,9,xyz,2038-09-09
6400,2502,3898,2009,9,10,xyz,2038-09-10
8118,5106,3012,2009,9,11,xyz,2038-09-11
5626,4467,1159,2009,9,12,xyz,2038-09-12
8630,7468,1162,2009,9,13,xyz,2038-09-13
6050,4936,1114,2009,9,14,xyz,2038-09-14
7527,1295,6232,2009,9,15,xyz,2038-09-15
2088,4994,-2906,2009,9,16,xyz,2038-09-16
1732,2903,-1171,2009,9,17,xyz,2038-09-17
2851,9165,-6314,2009,9,18,xyz,2038-09-18
2211,2056,155,2009,9,19,xyz,2038-09-19
2715,4848,-2133,2009,9,20,xyz,2038-09-20
1907,5445,-3538,2009,9,21,xyz,2038-09-21
9900,4370,5530,2009,9,22,xyz,2038-09-22
4757,9723,-4966,2009,9,23,xyz,2038-09-23
8172,2649,5523,2009,9,24,xyz,2038-09-24
8753,5057,3696,2009,9,25,xyz,2038-09-25
2325,4003,-1678,2009,9,26,xyz,2038-09-26
7850,7463,387,2009,9,27,xyz,2038-09-27
5655,5477,178,2009,9,28,xyz,2038-09-28
7590,3372,4218,2009,9,29,xyz,2038-09-29
8179,5755,2424,2009,9,30,xyz,2038-09-30
5935,8591,-2656,2009,10,1,xyz,2038-10-01
9514,562,8952,2009,10,2,xyz,2038-10-02
3437,8629,-5192,2009,10,3,xyz,2038-10-03
9265,5954,3311,2009,10,4,xyz,2038-10-04
5279,1288,3991,2009,10,5,xyz,2038-10-05
9697,2422,7275,2009,10,6,xyz,2038-10-06
2934,4604,-1670,2009,10,7,xyz,2038-10-07
7217,4867,2350,2009,10,8,xyz,2038-10-08
5943,6351,-408,2009,10,9,xyz,2038-10-09
3933,5858,-1925,2009,10,10,xyz,2038-10-10
8870,5756,3114,2009,10,11,xyz,2038-10-11
7552,1843,5709,2009,10,12,xyz,2038-10-12
10000,9826,174,2009,10,13,xyz,2038-10-13
5470,2364,3106,2009,10,14,xyz,2038-10-14
7312,3338,3974,2009,10,15,xyz,2038-10-15
4155,3314,841,2009,10,16,xyz,2038-10-16
7259,7625,-366,2009,10,17,xyz,2038-10-17
3674,1034,2640,2009,10,18,xyz,2038-10-18
8719,3692,5027,2009,10,19,xyz,2038-10-19
3389,7127,-3738,2009,10,20,xyz,2038-10-20
4380,1866,2514,2009,10,21,xyz,2038-10-21
5060,2190,2870,2009,10,22,xyz,2038-10-22
2184,6129,-3945,2009,10,23,xyz,2038-10-23
9551,4161,5390,2009,10,24,xyz,2038-10-24
9400,8116,1284,2009,10,25,xyz,2038-10-25
1632,1406,226,2009,10,26,xyz,2038-10-26
3342,5891,-2549,2009,10,27,xyz,2038-10-27
3483,5556,-2073,2009,10,28,xyz,2038-10-28
9172,7628,1544,2009,10,29,xyz,2038-10-29
1525,4925,-3400,2009,10,30,xyz,2038-10-30
2553,9523,-6970,2009,10,31,xyz,2038-10-31
9318,4193,5125,2009,11,1,xyz,2038-11-01
6400,3846,2554,2009,11,2,xyz,2038-11-02
5482,526,4956,2009,11,3,xyz,2038-11-03
4921,7241,-2320,2009,11,4,xyz,2038-11-04
5574,5588,-14,2009,11,5,xyz,2038-11-05
6501,9141,-2640,2009,11,6,xyz,2038-11-06
3282,593,2689,2009,11,7,xyz,2038-11-07
2579,769,1810,2009,11,8,xyz,2038-11-08
4773,7486,-2713,2009,11,9,xyz,2038-11-09
4854,3180,1674,2009,11,10,xyz,2038-11-10
7153,6888,265,2009,11,11,xyz,2038-11-11
9847,8417,1430,2009,11,12,xyz,2038-11-12
7498,6190,1308,2009,11,13,xyz,2038-11-13
4394,7709,-3315,2009,11,14,xyz,2038-11-14
6658,1529,5129,2009,11,15,xyz,2038-11-15
2432,4279,-1847,2009,11,16,xyz,2038-11-16
2541,7821,-5280,2009,11,17,xyz,2038-11-17
2115,8061,-5946,2009,11,18,xyz,2038-11-18
8939,3949,4990,2009,11,19,xyz,2038-11-19
8677,9032,-355,2009,11,20,xyz,2038-11-20
1136,8061,-6925,2009,11,21,xyz,2038-11-21
2489,1683,806,2009,11,22,xyz,2038-11-22
1714,3676,-1962,2009,11,23,xyz,2038-11-23
5010,9391,-4381,2009,11,24,xyz,2038-11-24
1110,4051,-2941,2009,11,25,xyz,2038-11-25
5612,1242,4370,2009,11,26,xyz,2038-11-26
9754,4126,5628,2009,11,27,xyz,2038-11-27
9710,4521,5189,2009,11,28,xyz,2038-11-28
9022,2713,6309,2009,11,29,xyz,2038-11-29
3242,6401,-3159,2009,11,30,xyz,2038-11-30
3614,7503,-3889,2009,12,1,xyz,2038-12-01
9996,7285,2711,2009,12,2,xyz,2038-12-02
6846,7434,-588,2009,12,3,xyz,2038-12-03
3884,3292,592,2009,12,4,xyz,2038-12-04
9305,5168,4137,2009,12,5,xyz,2038-12-05
2548,6058,-3510,2009,12,6,xyz,2038-12-06
8188,8928,-740,2009,12,7,xyz,2038-12-07
4066,740,3326,2009,12,8,xyz,2038-12-08
4412,6911,-2499,2009,12,9,xyz,2038-12-09
9407,5188,4219,2009,12,10,xyz,2038-12-10
3884,6172,-2288,2009,12,11,xyz,2038-12-11
9879,2330,7549,2009,12,12,xyz,2038-12-12
7637,7633,4,2009,12,13,xyz,2038-12-13
5883,1616,4267,2009,12,14,xyz,2038-12-14
6185,7818,-1633,2009,12,15,xyz,2038-12-15
8134,6279,1855,2009,12,16,xyz,2038-12-16
9269,9960,-691,2009,12,17,xyz,2038-12-17
6302,2252,4050,2009,12,18,xyz,2038-12-18
8035,5411,2624,2009,12,19,xyz,2038-12-19
5780,8494,-2714,2009,12,20,xyz,2038-12-20
3047,1432,1615,2009,12,21,xyz,2038-12-21
2440,8994,-6554,2009,12,22,xyz,2038-12-22
1884,2702,-818,2009,12,23,xyz,2038-12-23
8565,3607,4958,2009,12,24,xyz,2038-12-24
6548,7371,-823,2009,12,25,xyz,2038-12-25
9980,6767,3213,2009,12,26,xyz,2038-12-26
3924,4368,-444,2009,12,27,xyz,2038-12-27
4503,8313,-3810,2009,12,28,xyz,2038-12-28
7605,3451,4154,2009,12,29,xyz,2038-12-29
9062,8251,811,2009,12,30,xyz,2038-12-30
3233,6682,-3449,2009,12,31,xyz,2038-12-31
9985,2346,7639,2010,1,1,xyz,2039-01-01
7751,6493,1258,2010,1,2,xyz,2039-01-02
1342,3632,-2290,2010,1,3,xyz,2039-01-03
9876,3675,6201,2010,1,4,xyz,2039-01-04
5677,8341,-2664,2010,1,5,xyz,2039-01-05
5297,2180,3117,2010,1,6,xyz,2039-01-06
1960,3384,-1424,2010,1,7,xyz,2039-01-07
2006,8700,-6694,2010,1,8,xyz,2039-01-08
8860,4547,4313,2010,1,9,xyz,2039-01-09
9271,2024,7247,2010,1,10,xyz,2039-01-10
5730,2590,3140,2010,1,11,xyz,2039-01-11
7125,1679,5446,2010,1,12,xyz,2039-01-12
5190,8616,-3426,2010,1,13,xyz,2039-01-13
6974,7789,-815,2010,1,14,xyz,2039-01-14
3588,3528,60,2010,1,15,xyz,2039-01-15
8741,8945,-204,2010,1,16,xyz,2039-01-16
8506,5495,3011,2010,1,17,xyz,2039-01-17
8645,6756,1889,2010,1,18,xyz,2039-01-18
3768,8193,-4425,2010,1,19,xyz,2039-01-19
5237,1396,3841,2010,1,20,xyz,2039-01-20
7044,5204,1840,2010,1,21,xyz,2039-01-21
9076,4982,4094,2010,1,22,xyz,2039-01-22
1306,1352,-46,2010,1,23,xyz,2039-01-23
4006,1253,2753,2010,1,24,xyz,2039-01-24
6830,8773,-1943,2010,1,25,xyz,2039-01-25
1980,6026,-4046,2010,1,26,xyz,2039-01-26
8735,1184,7551,2010,1,27,xyz,2039-01-27
4814,1858,2956,2010,1,28,xyz,2039-01-28
3676,6516,-2840,2010,1,29,xyz,2039-01-29
9856,2922,6934,2010,1,30,xyz,2039-01-30
4025,9444,-5419,2010,1,31,xyz,2039-01-31
7395,4273,3122,2010,2,1,xyz,2039-02-01
4797,8244,-3447,2010,2,2,xyz,2039-02-02
5136,7838,-2702,2010,2,3,xyz,2039-02-03
5526,3849,1677,2010,2,4,xyz,2039-02-04
2341,2372,-31,2010,2,5,xyz,2039-02-05
5569,5643,-74,2010,2,6,xyz,2039-02-06
6587,3910,2677,2010,2,7,xyz,2039-02-07
5831,4140,1691,2010,2,8,xyz,2039-02-08
2929,9430,-6501,2010,2,9,xyz,2039-02-09
5466,8280,-2814,2010,2,10,xyz,2039-02-10
6156,7702,-1546,2010,2,11,xyz,2039-02-11
3292,5891,-2599,2010,2,12,xyz,2039-02-12
8829,5199,3630,2010,2,13,xyz,2039-02-13
1418,7908,-6490,2010,2,14,xyz,2039-02-14
3215,1564,1651,2010,2,15,xyz,2039-02-15
5298,6999,-1701,2010,2,16,xyz,2039-02-16
5286,5232,54,2010,2,17,xyz,2039-02-17
7246,6037,1209,2010,2,18,xyz,2039-02-18
8687,1338,7349,2010,2,19,xyz,2039-02-19
7119,9891,-2772,2010,2,20,xyz,2039-02-20
8276,9798,-1522,2010,2,21,xyz,2039-02-21
1170,2018,-848,2010,2,22,xyz,2039-02-22
9983,9730,253,2010,2,23,xyz,2039-02-23
8774,2275,6499,2010,2,24,xyz,2039-02-24
1386,4695,-3309,2010,2,25,xyz,2039-02-25
8154,9974,-1820,2010,2,26,xyz,2039-02-26
5283,8576,-3293,2010,2,27,xyz,2039-02-27
6719,4982,1737,2010,2,28,xyz,2039-02-28
5166,1771,3395,2010,3,1,xyz,2039-03-01
2527,3742,-1215,2010,3,2,xyz,2039-03-02
7682,8851,-1169,2010,3,3,xyz,2039-03-03
1594,2265,-671,2010,3,4,xyz,2039-03-04
6334,3757,2577,2010,3,5,xyz,2039-03-05
4951,2592,2359,2010,3,6,xyz,2039-03-06
1500,2138,-638,2010,3,7,xyz,2039-03-07
4844,4444,400,2010,3,8,xyz,2039-03-08
4389,4015,374,2010,3,9,xyz,2039-03-09
2846,6630,-3784,2010,3,10,xyz,2039-03-10
7367,9774,-2407,2010,3,11,xyz,2039-03-11
5265,5111,154,2010,3,12,xyz,2039-03-12
8937,7059,1878,2010,3,13,xyz,2039-03-13
3255,4286,-1031,2010,3,14,xyz,2039-03-14
8716,3716,5000,2010,3,15,xyz,2039-03-15
4177,9373,-5196,2010,3,16,xyz,2039-03-16
2401,6730,-4329,2010,3,17,xyz,2039-03-17
8031,8706,-675,2010,3,18,xyz,2039-03-18
7637,2799,4838,2010,3,19,xyz,2039-03-19
4491,3047,1444,2010,3,20,xyz,2039-03-20
1419,9232,-7813,2010,3,21,xyz,2039-03-21
9881,3541,6340,2010,3,22,xyz,2039-03-22
7075,5826,1249,2010,3,23,xyz,2039-03-23
7976,4734,3242,2010,3,24,xyz,2039-03-24
4495,9782,-5287,2010,3,25,xyz,2039-03-25
7713,4567,3146,2010,3,26,xyz,2039-03-26
1840,4030,-2190,2010,3,27,xyz,2039-03-27
8538,9825,-1287,2010,3,28,xyz,2039-03-28
3233,5123,-1890,2010,3,29,xyz,2039-03-29
8600,9239,-639,2010,3,30,xyz,2039-03-30
7511,4534,2977,2010,3,31,xyz,2039-03-31
5439,9844,-4405,2010,4,1,xyz,2039-04-01
4961,7178,-2217,2010,4,2,xyz,2039-04-02
3688,8871,-5183,2010,4,3,xyz,2039-04-03
6028,3755,2273,2010,4,4,xyz,2039-04-04
5519,4616,903,2010,4,5,xyz,2039-04-05
8473,5490,2983,2010,4,6,xyz,2039-04-06
9706,6109,3597,2010,4,7,xyz,2039-04-07
9932,5678,4254,2010,4,8,xyz,2039-04-08
3663,6270,-2607,2010,4,9,xyz,2039-04-09
5067,9785,-4718,2010,4,10,xyz,2039-04-10
1249,7711,-6462,2010,4,11,xyz,2039-04-11
2454,6429,-3975,2010,4,12,xyz,2039-04-12
3062,4606,-1544,2010,4,13,xyz,2039-04-13
3390,5438,-2048,2010,4,14,xyz,2039-04-14
7767,1255,6512,2010,4,15,xyz,2039-04-15
1929,668,1261,2010,4,16,xyz,2039-04-16
1814,656,1158,2010,4,17,xyz,2039-04-17
9877,6173,3704,2010,4,18,xyz,2039-04-18
7337,5894,1443,2010,4,19,xyz,2039-04-19
2471,9042,-6571,2010,4,20,xyz,2039-04-20
3347,4938,-1591,2010,4,21,xyz,2039-04-21
3143,5155,-2012,2010,4,22,xyz,2039-04-22
9957,8361,1596,2010,4,23,xyz,2039-04-23
2347,3726,-1379,2010,4,24,xyz,2039-04-24
7594,3908,3686,2010,4,25,xyz,2039-04-25
9939,3574,6365,2010,4,26,xyz,2039-04-26
2783,7264,-4481,2010,4,27,xyz,2039-04-27
6652,1584,5068,2010,4,28,xyz,2039-04-28
6874,8354,-1480,2010,4,29,xyz,2039-04-29
8690,1694,6996,2010,4,30,xyz,2039-04-30
9110,3394,5716,2010,5,1,xyz,2039-05-01
7020,8222,-1202,2010,5,2,xyz,2039-05-02
6526,7899,-1373,2010,5,3,xyz,2039-05-03
5048,3067,1981,2010,5,4,xyz,2039-05-04
1525,9268,-7743,2010,5,5,xyz,2039-05-05
6230,9428,-3198,2010,5,6,xyz,2039-05-06
2492,5424,-2932,2010,5,7,xyz,2039-05-07
5838,9343,-3505,2010,5,8,xyz,2039-05-08
8761,5589,3172,2010,5,9,xyz,2039-05-09
6078,4546,1532,2010,5,10,xyz,2039-05-10
9894,3167,6727,2010,5,11,xyz,2039-05-11
3167,1312,1855,2010,5,12,xyz,2039-05-12
1987,2069,-82,2010,5,13,xyz,2039-05-13
6228,2352,3876,2010,5,14,xyz,2039-05-14
8130,4259,3871,2010,5,15,xyz,2039-05-15
1069,6435,-5366,2010,5,16,xyz,2039-05-16
3587,8074,-4487,2010,5,17,xyz,2039-05-17
1317,7254,-5937,2010,5,18,xyz,2039-05-18
8990,9099,-109,2010,5,19,xyz,2039-05-19
3189,7213,-4024,2010,5,20,xyz,2039-05-20
1990,7186,-5196,2010,5,21,xyz,2039-05-21
1717,5152,-3435,2010,5,22,xyz,2039-05-22
3087,4483,-1396,2010,5,23,xyz,2039-05-23
8606,4211,4395,2010,5,24,xyz,2039-05-24
9212,5874,3338,2010,5,25,xyz,2039-05-25
1384,2637,-1253,2010,5,26,xyz,2039-05-26
5824,8643,-2819,2010,5,27,xyz,2039-05-27
6072,6791,-719,2010,5,28,xyz,2039-05-28
9253,2824,6429,2010,5,29,xyz,2039-05-29
7622,9296,-1674,2010,5,30,xyz,2039-05-30
6944,1384,5560,2010,5,31,xyz,2039-05-31
8139,7702,437,2010,6,1,xyz,2039-06-01
6813,8524,-1711,2010,6,2,xyz,2039-06-02
3333,8595,-5262,2010,6,3,xyz,2039-06-03
3874,3437,437,2010,6,4,xyz,2039-06-04
2920,2734,186,2010,6,5,xyz,2039-06-05
8353,5315,3038,2010,6,6,xyz,2039-06-06
4838,9309,-4471,2010,6,7,xyz,2039-06-07
1045,6299,-5254,2010,6,8,xyz,2039-06-08
4907,8307,-3400,2010,6,9,xyz,2039-06-09
3176,3713,-537,2010,6,10,xyz,2039-06-10
1514,1205,309,2010,6,11,xyz,2039-06-11
8667,2075,6592,2010,6,12,xyz,2039-06-12
9799,2390,7409,2010,6,13,xyz,2039-06-13
8413,3595,4818,2010,6,14,xyz,2039-06-14
9043,8574,469,2010,6,15,xyz,2039-06-15
2469,5644,-3175,2010,6,16,xyz,2039-06-16
3738,7413,-3675,2010,6,17,xyz,2039-06-17
1893,978,915,2010,6,18,xyz,2039-06-18
8721,2479,6242,2010,6,19,xyz,2039-06-19
5205,2608,2597,2010,6,20,xyz,2039-06-20
4425,4825,-400,2010,6,21,xyz,2039-06-21
6451,2357,4094,2010,6,22,xyz,2039-06-22
6181,4678,1503,2010,6,23,xyz,2039-06-23
7839,5150,2689,2010,6,24,xyz,2039-06-24
2171,1776,395,2010,6,25,xyz,2039-06-25
7512,4259,3253,2010,6,26,xyz,2039-06-26
1874,6091,-4217,2010,6,27,xyz,2039-06-27
4691,9691,-5000,2010,6,28,xyz,2039-06-28
2937,3865,-928,2010,6,29,xyz,2039-06-29
7790,7071,719,2010,6,30,xyz,2039-06-30
5885,2183,3702,2010,7,1,xyz,2039-07-01
6428,2442,3986,2010,7,2,xyz,2039-07-02
2510,679,1831,2010,7,3,xyz,2039-07-03
1200,2742,-1542,2010,7,4,xyz,2039-07-04
7098,6801,297,2010,7,5,xyz,2039-07-05
2751,6360,-3609,2010,7,6,xyz,2039-07-06
4398,5956,-1558,2010,7,7,xyz,2039-07-07
3637,602,3035,2010,7,8,xyz,2039-07-08
1436,6238,-4802,2010,7,9,xyz,2039-07-09
1280,8953,-7673,2010,7,10,xyz,2039-07-10
5259,4304,955,2010,7,11,xyz,2039-07-11
5030,1260,3770,2010,7,12,xyz,2039-07-12
1880,4145,-2265,2010,7,13,xyz,2039-07-13
5545,4440,1105,2010,7,14,xyz,2039-07-14
9654,5207,4447,2010,7,15,xyz,2039-07-15
4662,2061,2601,2010,7,16,xyz,2039-07-16
6796,4501,2295,2010,7,17,xyz,2039-07-17
7334,7050,284,2010,7,18,xyz,2039-07-18
3699,1035,2664,2010,7,19,xyz,2039-07-19
1160,6862,-5702,2010,7,20,xyz,2039-07-20
7767,8134,-367,2010,7,21,xyz,2039-07-21
3774,5256,-1482,2010,7,22,xyz,2039-07-22
3795,1560,2235,2010,7,23,xyz,2039-07-23
6721,1065,5656,2010,7,24,xyz,2039-07-24
9962,2431,7531,2010,7,25,xyz,2039-07-25
3266,9093,-5827,2010,7,26,xyz,2039-07-26
4070,6011,-1941,2010,7,27,xyz,2039-07-27
8883,4128,4755,2010,7,28,xyz,2039-07-28
5773,4788,985,2010,7,29,xyz,2039-07-29
1234,6222,-4988,2010,7,30,xyz,2039-07-30
3388,7243,-3855,2010,7,31,xyz,2039-07-31
6848,8006,-1158,2010,8,1,xyz,2039-08-01
4973,7448,-2475,2010,8,2,xyz,2039-08-02
1728,4266,-2538,2010,8,3,xyz,2039-08-03
7571,9888,-2317,2010,8,4,xyz,2039-08-04
4612,4985,-373,2010,8,5,xyz,2039-08-05
2384,3861,-1477,2010,8,6,xyz,2039-08-06
8461,2904,5557,2010,8,7,xyz,2039-08-07
5623,9599,-3976,2010,8,8,xyz,2039-08-08
9768,6729,3039,2010,8,9,xyz,2039-08-09
9896,9814,82,2010,8,10,xyz,2039-08-10
5848,6549,-701,2010,8,11,xyz,2039-08-11
7693,1606,6087,2010,8,12,xyz,2039-08-12
8610,4034,4576,2010,8,13,xyz,2039-08-13
3519,2688,831,2010,8,14,xyz,2039-08-14
2367,9725,-7358,2010,8,15,xyz,2039-08-15
7546,8975,-1429,2010,8,16,xyz,2039-08-16
5854,6749,-895,2010,8,17,xyz,2039-08-17
9751,9150,601,2010,8,18,xyz,2039-08-18
7932,9447,-1515,2010,8,19,xyz,2039-08-19
3828,1788,2040,2010,8,20,xyz,2039-08-20
7952,6296,1656,2010,8,21,xyz,2039-08-21
8029,3816,4213,2010,8,22,xyz,2039-08-22
4311,4716,-405,2010,8,23,xyz,2039-08-23
1409,3514,-2105,2010,8,24,xyz,2039-08-24
3012,7168,-4156,2010,8,25,xyz,2039-08-25
9380,2146,7234,2010,8,26,xyz,2039-08-26
6013,6597,-584,2010,8,27,xyz,2039-08-27
1465,3823,-2358,2010,8,28,xyz,2039-08-28
9537,4248,5289,2010,8,29,xyz,2039-08-29
9552,3019,6533,2010,8,30,xyz,2039-08-30
2167,6124,-3957,2010,8,31,xyz,2039-08-31
9287,1634,7653,2010,9,1,xyz,2039-09-01
3112,5663,-2551,2010,9,2,xyz,2039-09-02
8350,2297,6053,2010,9,3,xyz,2039-09-03
2346,8414,-6068,2010,9,4,xyz,2039-09-04
4263,2113,2150,2010,9,5,xyz,2039-09-05
5533,5043,490,2010,9,6,xyz,2039-09-06
4813,3898,915,2010,9,7,xyz,2039-09-07
8253,2746,5507,2010,9,8,xyz,2039-09-08
5347,6871,-1524,2010,9,9,xyz,2039-09-09
8711,9873,-1162,2010,9,10,xyz,2039-09-10
9380,1022,8358,2010,9,11,xyz,2039-09-11
3087,1531,1556,2010,9,12,xyz,2039-09-12
2923,1233,1690,2010,9,13,xyz,2039-09-13
3278,3054,224,2010,9,14,xyz,2039-09-14
2618,3236,-618,2010,9,15,xyz,2039-09-15
3837,998,2839,2010,9,16,xyz,2039-09-16
2349,4454,-2105,2010,9,17,xyz,2039-09-17
1583,2376,-793,2010,9,18,xyz,2039-09-18
7002,9000,-1998,2010,9,19,xyz,2039-09-19
8213,4692,3521,2010,9,20,xyz,2039-09-20
4031,3029,1002,2010,9,21,xyz,2039-09-21
2903,3941,-1038,2010,9,22,xyz,2039-09-22
1238,6062,-4824,2010,9,23,xyz,2039-09-23
4399,5609,-1210,2010,9,24,xyz,2039-09-24
5997,8271,-2274,2010,9,25,xyz,2039-09-25
4693,7043,-2350,2010,9,26,xyz,2039-09-26
4735,1392,3343,2010,9,27,xyz,2039-09-27
1972,1835,137,2010,9,28,xyz,2039-09-28
8225,7038,1187,2010,9,29,xyz,2039-09-29
2030,5423,-3393,2010,9,30,xyz,2039-09-30
3394,7870,-4476,2010,10,1,xyz,2039-10-01
6142,7193,-1051,2010,10,2,xyz,2039-10-02
9254,7147,2107,2010,10,3,xyz,2039-10-03
6906,8518,-1612,2010,10,4,xyz,2039-10-04
5475,8018,-2543,2010,10,5,xyz,2039-10-05
2419,9097,-6678,2010,10,6,xyz,2039-10-06
2854,7096,-4242,2010,10,7,xyz,2039-10-07
5153,9378,-4225,2010,10,8,xyz,2039-10-08
7180,5538,1642,2010,10,9,xyz,2039-10-09
1957,8194,-6237,2010,10,10,xyz,2039-10-10
7306,1263,6043,2010,10,11,xyz,2039-10-11
2931,4507,-1576,2010,10,12,xyz,2039-10-12
9343,4813,4530,2010,10,13,xyz,2039-10-13
5751,2597,3154,2010,10,14,xyz,2039-10-14
9790,7495,2295,2010,10,15,xyz,2039-10-15
1973,2097,-124,2010,10,16,xyz,2039-10-16
9664,3576,6088,2010,10,17,xyz,2039-10-17
8077,8464,-387,2010,10,18,xyz,2039-10-18
6051,1606,4445,2010,10,19,xyz,2039-10-19
6004,9147,-3143,2010,10,20,xyz,2039-10-20
9857,6971,2886,2010,10,21,xyz,2039-10-21
5315,1596,3719,2010,10,22,xyz,2039-10-22
3598,7532,-3934,2010,10,23,xyz,2039-10-23
2556,2935,-379,2010,10,24,xyz,2039-10-24
4419,8748,-4329,2010,10,25,xyz,2039-10-25
5342,4163,1179,2010,10,26,xyz,2039-10-26
4628,706,3922,2010,10,27,xyz,2039-10-27
2899,545,2354,2010,10,28,xyz,2039-10-28
3934,2536,1398,2010,10,29,xyz,2039-10-29
4923,3060,1863,2010,10,30,xyz,2039-10-30
5958,6539,-581,2010,10,31,xyz,2039-10-31
3375,8554,-5179,2010,11,1,xyz,2039-11-01
6015,8945,-2930,2010,11,2,xyz,2039-11-02
6122,1205,4917,2010,11,3,xyz,2039-11-03
2946,826,2120,2010,11,4,xyz,2039-11-04
1566,8684,-7118,2010,11,5,xyz,2039-11-05
5858,7659,-1801,2010,11,6,xyz,2039-11-06
1059,9217,-8158,2010,11,7,xyz,2039-11-07
8943,6248,2695,2010,11,8,xyz,2039-11-08
3907,7397,-3490,2010,11,9,xyz,2039-11-09
1420,2729,-1309,2010,11,10,xyz,2039-11-10
7704,875,6829,2010,11,11,xyz,2039-11-11
7702,9046,-1344,2010,11,12,xyz,2039-11-12
3813,5887,-2074,2010,11,13,xyz,2039-11-13
4234,8982,-4748,2010,11,14,xyz,2039-11-14
3686,3181,505,2010,11,15,xyz,2039-11-15
6264,8040,-1776,2010,11,16,xyz,2039-11-16
7994,7740,254,2010,11,17,xyz,2039-11-17
6211,2122,4089,2010,11,18,xyz,2039-11-18
1557,2948,-1391,2010,11,19,xyz,2039-11-19
6461,3311,3150,2010,11,20,xyz,2039-11-20
2549,700,1849,2010,11,21,xyz,2039-11-21
6493,9979,-3486,2010,11,22,xyz,2039-11-22
1298,1109,189,2010,11,23,xyz,2039-11-23
7065,514,6551,2010,11,24,xyz,2039-11-24
4008,2778,1230,2010,11,25,xyz,2039-11-25
2319,1991,328,2010,11,26,xyz,2039-11-26
8628,2195,6433,2010,11,27,xyz,2039-11-27
6103,4483,1620,2010,11,28,xyz,2039-11-28
6448,3612,2836,2010,11,29,xyz,2039-11-29
4615,2944,1671,2010,11,30,xyz,2039-11-30
6698,7220,-522,2010,12,1,xyz,2039-12-01
7576,3841,3735,2010,12,2,xyz,2039-12-02
6073,1919,4154,2010,12,3,xyz,2039-12-03
4557,6854,-2297,2010,12,4,xyz,2039-12-04
1502,2699,-1197,2010,12,5,xyz,2039-12-05
3785,4685,-900,2010,12,6,xyz,2039-12-06
5569,5698,-129,2010,12,7,xyz,2039-12-07
3192,4539,-1347,2010,12,8,xyz,2039-12-08
9728,5773,3955,2010,12,9,xyz,2039-12-09
4709,7575,-2866,2010,12,10,xyz,2039-12-10
9329,6714,2615,2010,12,11,xyz,2039-12-11
2338,7997,-5659,2010,12,12,xyz,2039-12-12
7839,1074,6765,2010,12,13,xyz,2039-12-13
5623,8538,-2915,2010,12,14,xyz,2039-12-14
8180,9942,-1762,2010,12,15,xyz,2039-12-15
2003,2258,-255,2010,12,16,xyz,2039-12-16
4539,9759,-5220,2010,12,17,xyz,2039-12-17
7652,8368,-716,2010,12,18,xyz,2039-12-18
9338,1607,7731,2010,12,19,xyz,2039-12-19
1431,3067,-1636,2010,12,20,xyz,2039-12-20
8633,1508,7125,2010,12,21,xyz,2039-12-21
8338,3667,4671,2010,12,22,xyz,2039-12-22
1246,3624,-2378,2010,12,23,xyz,2039-12-23
5118,966,4152,2010,12,24,xyz,2039-12-24
1424,716,708,2010,12,25,xyz,2039-12-25
7383,3200,4183,2010,12,26,xyz,2039-12-26
8821,1333,7488,2010,12,27,xyz,2039-12-27
5489,7261,-1772,2010,12,28,xyz,2039-12-28
6147,6295,-148,2010,12,29,xyz,2039-12-29
6373,5385,988,2010,12,30,xyz,2039-12-30
1475,9609,-8134,2010,12,31,xyz,2039-12-31
9464,9634,-170,2011,1,1,xyz,2040-01-01
4008,3947,61,2011,1,2,xyz,2040-01-02
7501,3494,4007,2011,1,3,xyz,2040-01-03
1779,1330,449,2011,1,4,xyz,2040-01-04
5089,9076,-3987,2011,1,5,xyz,2040-01-05
2050,6793,-4743,2011,1,6,xyz,2040-01-06
1633,9130,-7497,2011,1,7,xyz,2040-01-07
5258,3119,2139,2011,1,8,xyz,2040-01-08
3509,3142,367,2011,1,9,xyz,2040-01-09
7313,7748,-435,2011,1,10,xyz,2040-01-10
5764,7599,-1835,2011,1,11,xyz,2040-01-11
1061,7527,-6466,2011,1,12,xyz,2040-01-12
2806,6641,-3835,2011,1,13,xyz,2040-01-13
7463,9707,-2244,2011,1,14,xyz,2040-01-14
4209,2072,2137,2011,1,15,xyz,2040-01-15
5269,6895,-1626,2011,1,16,xyz,2040-01-16
1516,5355,-3839,2011,1,17,xyz,2040-01-17
8484,8880,-396,2011,1,18,xyz,2040-01-18
6397,8585,-2188,2011,1,19,xyz,2040-01-19
9973,3420,6553,2011,1,20,xyz,2040-01-20
6260,4891,1369,2011,1,21,xyz,2040-01-21
3798,4097,-299,2011,1,22,xyz,2040-01-22
6014,2990,3024,2011,1,23,xyz,2040-01-23
2603,8650,-6047,2011,1,24,xyz,2040-01-24
9809,8435,1374,2011,1,25,xyz,2040-01-25
1229,7529,-6300,2011,1,26,xyz,2040-01-26
7815,1550,6265,2011,1,27,xyz,2040-01-27
4545,3373,1172,2011,1,28,xyz,2040-01-28
7421,5906,1515,2011,1,29,xyz,2040-01-29
9334,3224,6110,2011,1,30,xyz,2040-01-30
2787,1594,1193,2011,1,31,xyz,2040-01-31
7292,8896,-1604,2011,2,1,xyz,2040-02-01
3118,7910,-4792,2011,2,2,xyz,2040-02-02
5431,1127,4304,2011,2,3,xyz,2040-02-03
5670,3782,1888,2011,2,4,xyz,2040-02-04
2247,9264,-7017,2011,2,5,xyz,2040-02-05
8928,2053,6875,2011,2,6,xyz,2040-02-06
9237,6079,3158,2011,2,7,xyz,2040-02-07
6645,4095,2550,2011,2,8,xyz,2040-02-08
7502,7183,319,2011,2,9,xyz,2040-02-09
3194,1148,2046,2011,2,10,xyz,2040-02-10
4297,1646,2651,2011,2,11,xyz,2040-02-11
9535,5481,4054,2011,2,12,xyz,2040-02-12
1128,3562,-2434,2011,2,13,xyz,2040-02-13
5531,4329,1202,2011,2,14,xyz,2040-02-14
1305,3992,-2687,2011,2,15,xyz,2040-02-15
8155,5841,2314,2011,2,16,xyz,2040-02-16
1704,2088,-384,2011,2,17,xyz,2040-02-17
6019,3890,2129,2011,2,18,xyz,2040-02-18
9105,3936,5169,2011,2,19,xyz,2040-02-19
9384,2344,7040,2011,2,20,xyz,2040-02-20
1331,8937,-7606,2011,2,21,xyz,2040-02-21
9241,8701,540,2011,2,22,xyz,2040-02-22
5840,4922,918,2011,2,23,xyz,2040-02-23
6310,2046,4264,2011,2,24,xyz,2040-02-24
8863,5681,3182,2011,2,25,xyz,2040-02-25
2936,5080,-2144,2011,2,26,xyz,2040-02-26
9893,7126,2767,2011,2,27,xyz,2040-02-27
2312,8276,-5964,2011,2,28,xyz,2040-02-28
8969,6648,2321,2011,2,29,xyz,2040-02-29
2385,2766,-381,2011,3,1,xyz,2040-03-01
5110,4414,696,2011,3,2,xyz,2040-03-02
4842,2655,2187,2011,3,3,xyz,2040-03-03
1321,584,737,2011,3,4,xyz,2040-03-04
9363,760,8603,2011,3,5,xyz,2040-03-05
6540,8606,-2066,2011,3,6,xyz,2040-03-06
2232,5319,-3087,2011,3,7,xyz,2040-03-07
2881,7835,-4954,2011,3,8,xyz,2040-03-08
9433,9458,-25,2011,3,9,xyz,2040-03-09
6097,3645,2452,2011,3,10,xyz,2040-03-10
3821,8485,-4664,2011,3,11,xyz,2040-03-11
9738,3950,5788,2011,3,12,xyz,2040-03-12
4267,3669,598,2011,3,13,xyz,2040-03-13
5977,8294,-2317,2011,3,14,xyz,2040-03-14
3440,8568,-5128,2011,3,15,xyz,2040-03-15
7851,3820,4031,2011,3,16,xyz,2040-03-16
2307,2048,259,2011,3,17,xyz,2040-03-17
2843,9262,-6419,2011,3,18,xyz,2040-03-18
4163,1023,3140,2011,3,19,xyz,2040-03-19
2021,7109,-5088,2011,3,20,xyz,2040-03-20
7843,6664,1179,2011,3,21,xyz,2040-03-21
9551,3212,6339,2011,3,22,xyz,2040-03-22
2908,4338,-1430,2011,3,23,xyz,2040-03-23
2677,9879,-7202,2011,3,24,xyz,2040-03-24
6582,4123,2459,2011,3,25,xyz,2040-03-25
4043,9256,-5213,2011,3,26,xyz,2040-03-26
7480,8247,-767,2011,3,27,xyz,2040-03-27
9666,5947,3719,2011,3,28,xyz,2040-03-28
4814,8071,-3257,2011,3,29,xyz,2040-03-29
1045,1537,-492,2011,3,30,xyz,2040-03-30
6080,3952,2128,2011,3,31,xyz,2040-03-31
6149,1087,5062,2011,4,1,xyz,2040-04-01
8378,4527,3851,2011,4,2,xyz,2040-04-02
4262,5662,-1400,2011,4,3,xyz,2040-04-03
5727,4808,919,2011,4,4,xyz,2040-04-04
1761,718,1043,2011,4,5,xyz,2040-04-05
8896,8995,-99,2011,4,6,xyz,2040-04-06
2119,862,1257,2011,4,7,xyz,2040-04-07
9977,6859,3118,2011,4,8,xyz,2040-04-08
7499,9788,-2289,2011,4,9,xyz,2040-04-09
8755,1144,7611,2011,4,10,xyz,2040-04-10
5878,9831,-3953,2011,4,11,xyz,2040-04-11
3677,3796,-119,2011,4,12,xyz,2040-04-12
4950,7070,-2120,2011,4,13,xyz,2040-04-13
9782,6508,3274,2011,4,14,xyz,2040-04-14
8817,5727,3090,2011,4,15,xyz,2040-04-15
4849,9228,-4379,2011,4,16,xyz,2040-04-16
3119,9218,-6099,2011,4,17,xyz,2040-04-17
3029,503,2526,2011,4,18,xyz,2040-04-18
3769,789,2980,2011,4,19,xyz,2040-04-19
6877,5142,1735,2011,4,20,xyz,2040-04-20
9094,1909,7185,2011,4,21,xyz,2040-04-21
6934,5760,1174,2011,4,22,xyz,2040-04-22
3855,2052,1803,2011,4,23,xyz,2040-04-23
9738,2151,7587,2011,4,24,xyz,2040-04-24
5313,1133,4180,2011,4,25,xyz,2040-04-25
6128,5818,310,2011,4,26,xyz,2040-04-26
7958,3259,4699,2011,4,27,xyz,2040-04-27
7849,3398,4451,2011,4,28,xyz,2040-04-28
3314,8339,-5025,2011,4,29,xyz,2040-04-29
1831,5011,-3180,2011,4,30,xyz,2040-04-30
3908,8777,-4869,2011,5,1,xyz,2040-05-01
5493,1590,3903,2011,5,2,xyz,2040-05-02
4289,3187,1102,2011,5,3,xyz,2040-05-03
4596,864,3732,2011,5,4,xyz,2040-05-04
1745,9980,-8235,2011,5,5,xyz,2040-05-05
5801,5383,418,2011,5,6,xyz,2040-05-06
2875,812,2063,2011,5,7,xyz,2040-05-07
9763,5398,4365,2011,5,8,xyz,2040-05-08
2199,8281,-6082,2011,5,9,xyz,2040-05-09
6472,4981,1491,2011,5,10,xyz,2040-05-10
9415,727,8688,2011,5,11,xyz,2040-05-11
5605,6540,-935,2011,5,12,xyz,2040-05-12
1708,4558,-2850,2011,5,13,xyz,2040-05-13
8204,9642,-1438,2011,5,14,xyz,2040-05-14
2574,8378,-5804,2011,5,15,xyz,2040-05-15
2623,3150,-527,2011,5,16,xyz,2040-05-16
4701,7516,-2815,2011,5,17,xyz,2040-05-17
9488,5047,4441,2011,5,18,xyz,2040-05-18
3068,7901,-4833,2011,5,19,xyz,2040-05-19
5650,912,4738,2011,5,20,xyz,2040-05-20
4464,3571,893,2011,5,21,xyz,2040-05-21
4685,3893,792,2011,5,22,xyz,2040-05-22
5598,8887,-3289,2011,5,23,xyz,2040-05-23
1225,4267,-3042,2011,5,24,xyz,2040-05-24
4223,563,3660,2011,5,25,xyz,2040-05-25
2120,2786,-666,2011,5,26,xyz,2040-05-26
3511,1511,2000,2011,5,27,xyz,2040-05-27
1689,6108,-4419,2011,5,28,xyz,2040-05-28
7540,4899,2641,2011,5,29,xyz,2040-05-29
4366,8855,-4489,2011,5,30,xyz,2040-05-30
7827,2405,5422,2011,5,31,xyz,2040-05-31
3645,1675,1970,2011,6,1,xyz,2040-06-01
2838,9700,-6862,2011,6,2,xyz,2040-06-02
2445,6288,-3843,2011,6,3,xyz,2040-06-03
5881,5233,648,2011,6,4,xyz,2040-06-04
8892,1695,7197,2011,6,5,xyz,2040-06-05
2809,2191,618,2011,6,6,xyz,2040-06-06
9925,6270,3655,2011,6,7,xyz,2040-06-07
3618,4964,-1346,2011,6,8,xyz,2040-06-08
7579,9650,-2071,2011,6,9,xyz,2040-06-09
5270,5044,226,2011,6,10,xyz,2040-06-10
2909,7357,-4448,2011,6,11,xyz,2040-06-11
5390,6242,-852,2011,6,12,xyz,2040-06-12
6158,5049,1109,2011,6,13,xyz,2040-06-13
6680,1634,5046,2011,6,14,xyz,2040-06-14
2812,8309,-5497,2011,6,15,xyz,2040-06-15
9611,7717,1894,2011,6,16,xyz,2040-06-16
7088,6986,102,2011,6,17,xyz,2040-06-17
8697,2125,6572,2011,6,18,xyz,2040-06-18
4064,7605,-3541,2011,6,19,xyz,2040-06-19
8256,7887,369,2011,6,20,xyz,2040-06-20
6138,2689,3449,2011,6,21,xyz,2040-06-21
9587,4104,5483,2011,6,22,xyz,2040-06-22
9096,1036,8060,2011,6,23,xyz,2040-06-23
5349,5161,188,2011,6,24,xyz,2040-06-24
2189,4166,-1977,2011,6,25,xyz,2040-06-25
5189,5704,-515,2011,6,26,xyz,2040-06-26
9888,7611,2277,2011,6,27,xyz,2040-06-27
1669,6917,-5248,2011,6,28,xyz,2040-06-28
8373,1230,7143,2011,6,29,xyz,2040-06-29
4114,5528,-1414,2011,6,30,xyz,2040-06-30
5766,4539,1227,2011,7,1,xyz,2040-07-01
9640,4613,5027,2011,7,2,xyz,2040-07-02
3852,7397,-3545,2011,7,3,xyz,2040-07-03
2291,4158,-1867,2011,7,4,xyz,2040-07-04
7258,4684,2574,2011,7,5,xyz,2040-07-05
5322,4051,1271,2011,7,6,xyz,2040-07-06
1604,8760,-7156,2011,7,7,xyz,2040-07-07
2863,547,2316,2011,7,8,xyz,2040-07-08
4389,8354,-3965,2011,7,9,xyz,2040-07-09
2305,7629,-5324,2011,7,10,xyz,2040-07-10
7032,8006,-974,2011,7,11,xyz,2040-07-11
2643,9406,-6763,2011,7,12,xyz,2040-07-12
6235,9645,-3410,2011,7,13,xyz,2040-07-13
4474,7464,-2990,2011,7,14,xyz,2040-07-14
5573,3018,2555,2011,7,15,xyz,2040-07-15
7511,2205,5306,2011,7,16,xyz,2040-07-16
3944,9219,-5275,2011,7,17,xyz,2040-07-17
1819,7304,-5485,2011,7,18,xyz,2040-07-18
2804,8330,-5526,2011,7,19,xyz,2040-07-19
9744,6823,2921,2011,7,20,xyz,2040-07-20
4079,6881,-2802,2011,7,21,xyz,2040-07-21
9334,9067,267,2011,7,22,xyz,2040-07-22
1695,1121,574,2011,7,23,xyz,2040-07-23
8111,3270,4841,2011,7,24,xyz,2040-07-24
7209,3197,4012,2011,7,25,xyz,2040-07-25
6671,3831,2840,2011,7,26,xyz,2040-07-26
8804,9370,-566,2011,7,27,xyz,2040-07-27
5004,1961,3043,2011,7,28,xyz,2040-07-28
2279,2992,-713,2011,7,29,xyz,2040-07-29
4228,1818,2410,2011,7,30,xyz,2040-07-30
7108,5576,1532,2011,7,31,xyz,2040-07-31
1553,571,982,2011,8,1,xyz,2040-08-01
2860,9350,-6490,2011,8,2,xyz,2040-08-02
8174,9249,-1075,2011,8,3,xyz,2040-08-03
2173,6266,-4093,2011,8,4,xyz,2040-08-04
6643,8751,-2108,2011,8,5,xyz,2040-08-05
1577,6874,-5297,2011,8,6,xyz,2040-08-06
7597,3984,3613,2011,8,7,xyz,2040-08-07
2121,4079,-1958,2011,8,8,xyz,2040-08-08
3420,8831,-5411,2011,8,9,xyz,2040-08-09
4086,6164,-2078,2011,8,10,xyz,2040-08-10
5684,9972,-4288,2011,8,11,xyz,2040-08-11
8384,517,7867,2011,8,12,xyz,2040-08-12
1980,3638,-1658,2011,8,13,xyz,2040-08-13
5987,8612,-2625,2011,8,14,xyz,2040-08-14
9185,3442,5743,2011,8,15,xyz,2040-08-15
7258,4951,2307,2011,8,16,xyz,2040-08-16
3691,833,2858,2011,8,17,xyz,2040-08-17
9747,2692,7055,2011,8,18,xyz,2040-08-18
7606,8955,-1349,2011,8,19,xyz,2040-08-19
1118,5164,-4046,2011,8,20,xyz,2040-08-20
3125,5423,-2298,2011,8,21,xyz,2040-08-21
5309,7715,-2406,2011,8,22,xyz,2040-08-22
6800,4783,2017,2011,8,23,xyz,2040-08-23
4391,2560,1831,2011,8,24,xyz,2040-08-24
1663,2341,-678,2011,8,25,xyz,2040-08-25
4742,8487,-3745,2011,8,26,xyz,2040-08-26
2600,3210,-610,2011,8,27,xyz,2040-08-27
7829,3798,4031,2011,8,28,xyz,2040-08-28
9372,8394,978,2011,8,29,xyz,2040-08-29
2493,3105,-612,2011,8,30,xyz,2040-08-30
9374,4549,4825,2011,8,31,xyz,2040-08-31
4886,8840,-3954,2011,9,1,xyz,2040-09-01
9071,7687,1384,2011,9,2,xyz,2040-09-02
7429,9162,-1733,2011,9,3,xyz,2040-09-03
3036,686,2350,2011,9,4,xyz,2040-09-04
8260,2701,5559,2011,9,5,xyz,2040-09-05
4214,9466,-5252,2011,9,6,xyz,2040-09-06
7843,9987,-2144,2011,9,7,xyz,2040-09-07
7609,1658,5951,2011,9,8,xyz,2040-09-08
4421,639,3782,2011,9,9,xyz,2040-09-09
3752,7003,-3251,2011,9,10,xyz,2040-09-10
4268,6801,-2533,2011,9,11,xyz,2040-09-11
4734,3487,1247,2011,9,12,xyz,2040-09-12
6786,6688,98,2011,9,13,xyz,2040-09-13
7152,8662,-1510,2011,9,14,xyz,2040-09-14
3349,9217,-5868,2011,9,15,xyz,2040-09-15
8254,1419,6835,2011,9,16,xyz,2040-09-16
4262,4420,-158,2011,9,17,xyz,2040-09-17
5586,2855,2731,2011,9,18,xyz,2040-09-18
4730,6592,-1862,2011,9,19,xyz,2040-09-19
5108,3385,1723,2011,9,20,xyz,2040-09-20
5607,6588,-981,2011,9,21,xyz,2040-09-21
8593,896,7697,2011,9,22,xyz,2040-09-22
9389,2514,6875,2011,9,23,xyz,2040-09-23
8728,7208,1520,2011,9,24,xyz,2040-09-24
3858,4097,-239,2011,9,25,xyz,2040-09-25
7106,2799,4307,2011,9,26,xyz,2040-09-26
6943,1115,5828,2011,9,27,xyz,2040-09-27
9654,2018,7636,2011,9,28,xyz,2040-09-28
7763,9791,-2028,2011,9,29,xyz,2040-09-29
7536,6686,850,2011,9,30,xyz,2040-09-30
2464,1834,630,2011,10,1,xyz,2040-10-01
1885,8372,-6487,2011,10,2,xyz,2040-10-02
9973,1013,8960,2011,10,3,xyz,2040-10-03
8049,6338,1711,2011,10,4,xyz,2040-10-04
7169,5583,1586,2011,10,5,xyz,2040-10-05
3566,6893,-3327,2011,10,6,xyz,2040-10-06
7783,4996,2787,2011,10,7,xyz,2040-10-07
3283,8850,-5567,2011,10,8,xyz,2040-10-08
7046,8519,-1473,2011,10,9,xyz,2040-10-09
3962,2899,1063,2011,10,10,xyz,2040-10-10
1294,2001,-707,2011,10,11,xyz,2040-10-11
3225,5662,-2437,2011,10,12,xyz,2040-10-12
3465,3611,-146,2011,10,13,xyz,2040-10-13
7677,2769,4908,2011,10,14,xyz,2040-10-14
9212,1653,7559,2011,10,15,xyz,2040-10-15
9161,5365,3796,2011,10,16,xyz,2040-10-16
9499,3500,5999,2011,10,17,xyz,2040-10-17
5254,2874,2380,2011,10,18,xyz,2040-10-18
4301,4990,-689,2011,10,19,xyz,2040-10-19
8754,1502,7252,2011,10,20,xyz,2040-10-20
7035,1545,5490,2011,10,21,xyz,2040-10-21
6315,2503,3812,2011,10,22,xyz,2040-10-22
1171,8885,-7714,2011,10,23,xyz,2040-10-23
9866,6974,2892,2011,10,24,xyz,2040-10-24
1521,521,1000,2011,10,25,xyz,2040-10-25
3333,6817,-3484,2011,10,26,xyz,2040-10-26
8062,5574,2488,2011,10,27,xyz,2040-10-27
3837,9167,-5330,2011,10,28,xyz,2040-10-28
4948,1909,3039,2011,10,29,xyz,2040-10-29
3308,6372,-3064,2011,10,30,xyz,2040-10-30
7118,9496,-2378,2011,10,31,xyz,2040-10-31
7902,3174,4728,2011,11,1,xyz,2040-11-01
1778,2682,-904,2011,11,2,xyz,2040-11-02
6078,1743,4335,2011,11,3,xyz,2040-11-03
8921,2669,6252,2011,11,4,xyz,2040-11-04
8328,776,7552,2011,11,5,xyz,2040-11-05
2600,883,1717,2011,11,6,xyz,2040-11-06
2098,9788,-7690,2011,11,7,xyz,2040-11-07
4103,4495,-392,2011,11,8,xyz,2040-11-08
3163,4964,-1801,2011,11,9,xyz,2040-11-09
7170,7237,-67,2011,11,10,xyz,2040-11-10
4336,3613,723,2011,11,11,xyz,2040-11-11
4702,2845,1857,2011,11,12,xyz,2040-11-12
3067,1384,1683,2011,11,13,xyz,2040-11-13
7315,1697,5618,2011,11,14,xyz,2040-11-14
7143,8646,-1503,2011,11,15,xyz,2040-11-15
7716,2121,5595,2011,11,16,xyz,2040-11-16
9326,8994,332,2011,11,17,xyz,2040-11-17
2619,6941,-4322,2011,11,18,xyz,2040-11-18
2468,5565,-3097,2011,11,19,xyz,2040-11-19
8388,5648,2740,2011,11,20,xyz,2040-11-20
1160,938,222,2011,11,21,xyz,2040-11-21
6684,6899,-215,2011,11,22,xyz,2040-11-22
7073,6095,978,2011,11,23,xyz,2040-11-23
5041,9925,-4884,2011,11,24,xyz,2040-11-24
2515,7073,-4558,2011,11,25,xyz,2040-11-25
9404,7852,1552,2011,11,26,xyz,2040-11-26
8592,5347,3245,2011,11,27,xyz,2040-11-27
8336,2378,5958,2011,11,28,xyz,2040-11-28
8647,1114,7533,2011,11,29,xyz,2040-11-29
6747,7466,-719,2011,11,30,xyz,2040-11-30
4792,7242,-2450,2011,12,1,xyz,2040-12-01
4026,7351,-3325,2011,12,2,xyz,2040-12-02
3232,7850,-4618,2011,12,3,xyz,2040-12-03
4448,5438,-990,2011,12,4,xyz,2040-12-04
5277,4398,879,2011,12,5,xyz,2040-12-05
4300,5410,-1110,2011,12,6,xyz,2040-12-06
6239,9595,-3356,2011,12,7,xyz,2040-12-07
2083,895,1188,2011,12,8,xyz,2040-12-08
5963,9465,-3502,2011,12,9,xyz,2040-12-09
6354,6974,-620,2011,12,10,xyz,2040-12-10
6389,8908,-2519,2011,12,11,xyz,2040-12-11
8720,1329,7391,2011,12,12,xyz,2040-12-12
8467,6997,1470,2011,12,13,xyz,2040-12-13
9713,9439,274,2011,12,14,xyz,2040-12-14
4662,706,3956,2011,12,15,xyz,2040-12-15
6032,5579,453,2011,12,16,xyz,2040-12-16
4911,8612,-3701,2011,12,17,xyz,2040-12-17
5403,3038,2365,2011,12,18,xyz,2040-12-18
8408,9083,-675,2011,12,19,xyz,2040-12-19
5157,8225,-3068,2011,12,20,xyz,2040-12-20
3956,5634,-1678,2011,12,21,xyz,2040-12-21
5466,6525,-1059,2011,12,22,xyz,2040-12-22
8954,7418,1536,2011,12,23,xyz,2040-12-23
5165,6200,-1035,2011,12,24,xyz,2040-12-24
6552,3759,2793,2011,12,25,xyz,2040-12-25
5075,3323,1752,2011,12,26,xyz,2040-12-26
5638,2630,3008,2011,12,27,xyz,2040-12-27
6258,5358,900,2011,12,28,xyz,2040-12-28
4947,3847,1100,2011,12,29,xyz,2040-12-29
7409,6679,730,2011,12,30,xyz,2040-12-30
4806,2796,2010,2011,12,31,xyz,2040-12-31
7925,2809,5116,2012,1,1,xyz,2041-01-01
9727,7134,2593,2012,1,2,xyz,2041-01-02
4950,3076,1874,2012,1,3,xyz,2041-01-03
2301,4859,-2558,2012,1,4,xyz,2041-01-04
5981,8675,-2694,2012,1,5,xyz,2041-01-05
2503,7286,-4783,2012,1,6,xyz,2041-01-06
3849,7295,-3446,2012,1,7,xyz,2041-01-07
8963,9348,-385,2012,1,8,xyz,2041-01-08
1352,9870,-8518,2012,1,9,xyz,2041-01-09
9814,8545,1269,2012,1,10,xyz,2041-01-10
6812,8666,-1854,2012,1,11,xyz,2041-01-11
9803,2730,7073,2012,1,12,xyz,2041-01-12
4854,2370,2484,2012,1,13,xyz,2041-01-13
9006,5745,3261,2012,1,14,xyz,2041-01-14
2890,2929,-39,2012,1,15,xyz,2041-01-15
4177,7451,-3274,2012,1,16,xyz,2041-01-16
2722,1233,1489,2012,1,17,xyz,2041-01-17
8378,2013,6365,2012,1,18,xyz,2041-01-18
2979,6888,-3909,2012,1,19,xyz,2041-01-19
5800,7420,-1620,2012,1,20,xyz,2041-01-20
7931,1844,6087,2012,1,21,xyz,2041-01-21
1550,2525,-975,2012,1,22,xyz,2041-01-22
5158,8283,-3125,2012,1,23,xyz,2041-01-23
2709,1496,1213,2012,1,24,xyz,2041-01-24
5740,1791,3949,2012,1,25,xyz,2041-01-25
6110,5910,200,2012,1,26,xyz,2041-01-26
2382,3147,-765,2012,1,27,xyz,2041-01-27
2728,3476,-748,2012,1,28,xyz,2041-01-28
7311,9301,-1990,2012,1,29,xyz,2041-01-29
6027,8074,-2047,2012,1,30,xyz,2041-01-30
8855,2208,6647,2012,1,31,xyz,2041-01-31
5136,7550,-2414,2012,2,1,xyz,2041-02-01
6625,9847,-3222,2012,2,2,xyz,2041-02-02
7674,2501,5173,2012,2,3,xyz,2041-02-03
3783,5168,-1385,2012,2,4,xyz,2041-02-04
1955,6723,-4768,2012,2,5,xyz,2041-02-05
3535,867,2668,2012,2,6,xyz,2041-02-06
8864,7214,1650,2012,2,7,xyz,2041-02-07
6272,3828,2444,2012,2,8,xyz,2041-02-08
7862,3388,4474,2012,2,9,xyz,2041-02-09
4841,4173,668,2012,2,10,xyz,2041-02-10
9854,5004,4850,2012,2,11,xyz,2041-02-11
8503,1410,7093,2012,2,12,xyz,2041-02-12
6067,2326,3741,2012,2,13,xyz,2041-02-13
2803,2799,4,2012,2,14,xyz,2041-02-14
2746,2950,-204,2012,2,15,xyz,2041-02-15
9686,2617,7069,2012,2,16,xyz,2041-02-16
2225,5416,-3191,2012,2,17,xyz,2041-02-17
7664,8035,-371,2012,2,18,xyz,2041-02-18
2575,6305,-3730,2012,2,19,xyz,2041-02-19
4566,2324,2242,2012,2,20,xyz,2041-02-20
5349,9158,-3809,2012,2,21,xyz,2041-02-21
9153,5712,3441,2012,2,22,xyz,2041-02-22
1974,4487,-2513,2012,2,23,xyz,2041-02-23
5612,9320,-3708,2012,2,24,xyz,2041-02-24
7963,7306,657,2012,2,25,xyz,2041-02-25
2475,5197,-2722,2012,2,26,xyz,2041-02-26
5195,7537,-2342,2012,2,27,xyz,2041-02-27
2087,7252,-5165,2012,2,28,xyz,2041-02-28
5304,6221,-917,2012,3,1,xyz,2041-03-01
7491,4399,3092,2012,3,2,xyz,2041-03-02
6831,8464,-1633,2012,3,3,xyz,2041-03-03
8229,4804,3425,2012,3,4,xyz,2041-03-04
6578,9066,-2488,2012,3,5,xyz,2041-03-05
8930,5142,3788,2012,3,6,xyz,2041-03-06
6317,5376,941,2012,3,7,xyz,2041-03-07
6751,657,6094,2012,3,8,xyz,2041-03-08
8326,9373,-1047,2012,3,9,xyz,2041-03-09
9258,2190,7068,2012,3,10,xyz,2041-03-10
2659,7793,-5134,2012,3,11,xyz,2041-03-11
7690,3426,4264,2012,3,12,xyz,2041-03-12
7068,1839,5229,2012,3,13,xyz,2041-03-13
9860,2055,7805,2012,3,14,xyz,2041-03-14
5741,3075,2666,2012,3,15,xyz,2041-03-15
8390,8835,-445,2012,3,16,xyz,2041-03-16
6379,1742,4637,2012,3,17,xyz,2041-03-17
9829,2678,7151,2012,3,18,xyz,2041-03-18
3151,6638,-3487,2012,3,19,xyz,2041-03-19
9265,2319,6946,2012,3,20,xyz,2041-03-20
4251,1280,2971,2012,3,21,xyz,2041-03-21
2914,4660,-1746,2012,3,22,xyz,2041-03-22
6141,8129,-1988,2012,3,23,xyz,2041-03-23
2827,5158,-2331,2012,3,24,xyz,2041-03-24
9657,9570,87,2012,3,25,xyz,2041-03-25
5760,7212,-1452,2012,3,26,xyz,2041-03-26
2335,841,1494,2012,3,27,xyz,2041-03-27
3986,4607,-621,2012,3,28,xyz,2041-03-28
4761,2956,1805,2012,3,29,xyz,2041-03-29
3373,7835,-4462,2012,3,30,xyz,2041-03-30
2489,9386,-6897,2012,3,31,xyz,2041-03-31
8380,727,7653,2012,4,1,xyz,2041-04-01
4727,1679,3048,2012,4,2,xyz,2041-04-02
4195,8927,-4732,2012,4,3,xyz,2041-04-03
5448,3416,2032,2012,4,4,xyz,2041-04-04
4606,854,3752,2012,4,5,xyz,2041-04-05
3669,5969,-2300,2012,4,6,xyz,2041-04-06
7692,1928,5764,2012,4,7,xyz,2041-04-07
9853,1542,8311,2012,4,8,xyz,2041-04-08
1355,8293,-6938,2012,4,9,xyz,2041-04-09
5367,2244,3123,2012,4,10,xyz,2041-04-10
3809,8096,-4287,2012,4,11,xyz,2041-04-11
3356,3262,94,2012,4,12,xyz,2041-04-12
2017,5669,-3652,2012,4,13,xyz,2041-04-13
9427,1143,8284,2012,4,14,xyz,2041-04-14
6953,5815,1138,2012,4,15,xyz,2041-04-15
7767,8226,-459,2012,4,16,xyz,2041-04-16
8213,3143,5070,2012,4,17,xyz,2041-04-17
2329,7894,-5565,2012,4,18,xyz,2041-04-18
2814,2586,228,2012,4,19,xyz,2041-04-19
6204,822,5382,2012,4,20,xyz,2041-04-20
6447,4788,1659,2012,4,21,xyz,2041-04-21
3507,5057,-1550,2012,4,22,xyz,2041-04-22
1996,2388,-392,2012,4,23,xyz,2041-04-23
2714,6654,-3940,2012,4,24,xyz,2041-04-24
3073,6004,-2931,2012,4,25,xyz,2041-04-25
4918,3415,1503,2012,4,26,xyz,2041-04-26
4493,7611,-3118,2012,4,27,xyz,2041-04-27
8194,8909,-715,2012,4,28,xyz,2041-04-28
7271,2602,4669,2012,4,29,xyz,2041-04-29
6439,4731,1708,2012,4,30,xyz,2041-04-30
3441,8044,-4603,2012,5,1,xyz,2041-05-01
4865,4820,45,2012,5,2,xyz,2041-05-02
2670,759,1911,2012,5,3,xyz,2041-05-03
4114,5902,-1788,2012,5,4,xyz,2041-05-04
1849,5769,-3920,2012,5,5,xyz,2041-05-05
6709,9370,-2661,2012,5,6,xyz,2041-05-06
6028,4032,1996,2012,5,7,xyz,2041-05-07
9738,2594,7144,2012,5,8,xyz,2041-05-08
5460,2930,2530,2012,5,9,xyz,2041-05-09
4517,6413,-1896,2012,5,10,xyz,2041-05-10
1983,4248,-2265,2012,5,11,xyz,2041-05-11
1132,2458,-1326,2012,5,12,xyz,2041-05-12
1136,4964,-3828,2012,5,13,xyz,2041-05-13
3082,5034,-1952,2012,5,14,xyz,2041-05-14
2295,2894,-599,2012,5,15,xyz,2041-05-15
6256,4347,1909,2012,5,16,xyz,2041-05-16
2208,3795,-1587,2012,5,17,xyz,2041-05-17
1210,8843,-7633,2012,5,18,xyz,2041-05-18
9836,3612,6224,2012,5,19,xyz,2041-05-19
7015,3707,3308,2012,5,20,xyz,2041-05-20
9725,2597,7128,2012,5,21,xyz,2041-05-21
2709,5565,-2856,2012,5,22,xyz,2041-05-22
8228,3313,4915,2012,5,23,xyz,2041-05-23
2766,7400,-4634,2012,5,24,xyz,2041-05-24
7148,7254,-106,2012,5,25,xyz,2041-05-25
1120,2822,-1702,2012,5,26,xyz,2041-05-26
9578,5239,4339,2012,5,27,xyz,2041-05-27
2173,9756,-7583,2012,5,28,xyz,2041-05-28
2218,5162,-2944,2012,5,29,xyz,2041-05-29
2117,9785,-7668,2012,5,30,xyz,2041-05-30
5330,4805,525,2012,5,31,xyz,2041-05-31
3582,2302,1280,2012,6,1,xyz,2041-06-01
5013,2156,2857,2012,6,2,xyz,2041-06-02
9380,5650,3730,2012,6,3,xyz,2041-06-03
9927,2049,7878,2012,6,4,xyz,2041-06-04
6819,1715,5104,2012,6,5,xyz,2041-06-05
7184,8286,-1102,2012,6,6,xyz,2041-06-06
4359,1555,2804,2012,6,7,xyz,2041-06-07
5593,3926,1667,2012,6,8,xyz,2041-06-08
1751,7727,-5976,2012,6,9,xyz,2041-06-09
5805,7502,-1697,2012,6,10,xyz,2041-06-10
5435,5307,128,2012,6,11,xyz,2041-06-11
6778,3366,3412,2012,6,12,xyz,2041-06-12
7052,7938,-886,2012,6,13,xyz,2041-06-13
2223,8381,-6158,2012,6,14,xyz,2041-06-14
4998,4038,960,2012,6,15,xyz,2041-06-15
1634,4647,-3013,2012,6,16,xyz,2041-06-16
2211,5687,-3476,2012,6,17,xyz,2041-06-17
2807,5917,-3110,2012,6,18,xyz,2041-06-18
8446,2599,5847,2012,6,19,xyz,2041-06-19
6995,8274,-1279,2012,6,20,xyz,2041-06-20
3984,1491,2493,2012,6,21,xyz,2041-06-21
3028,3156,-128,2012,6,22,xyz,2041-06-22
9393,3673,5720,2012,6,23,xyz,2041-06-23
2924,745,2179,2012,6,24,xyz,2041-06-24
2027,1669,358,2012,6,25,xyz,2041-06-25
3891,4837,-946,2012,6,26,xyz,2041-06-26
9013,1741,7272,2012,6,27,xyz,2041-06-27
3880,1315,2565,2012,6,28,xyz,2041-06-28
8196,1767,6429,2012,6,29,xyz,2041-06-29
2992,2212,780,2012,6,30,xyz,2041-06-30
6486,1704,4782,2012,7,1,xyz,2041-07-01
3746,5090,-1344,2012,7,2,xyz,2041-07-02
4823,2245,2578,2012,7,3,xyz,2041-07-03
1300,2612,-1312,2012,7,4,xyz,2041-07-04
1276,1223,53,2012,7,5,xyz,2041-07-05
8482,1949,6533,2012,7,6,xyz,2041-07-06
5033,8951,-3918,2012,7,7,xyz,2041-07-07
8247,5667,2580,2012,7,8,xyz,2041-07-08
6180,5198,982,2012,7,9,xyz,2041-07-09
6259,1609,4650,2012,7,10,xyz,2041-07-10
7391,3320,4071,2012,7,11,xyz,2041-07-11
6431,7701,-1270,2012,7,12,xyz,2041-07-12
1356,8711,-7355,2012,7,13,xyz,2041-07-13
8836,7147,1689,2012,7,14,xyz,2041-07-14
1288,8205,-6917,2012,7,15,xyz,2041-07-15
1593,7377,-5784,2012,7,16,xyz,2041-07-16
9383,5148,4235,2012,7,17,xyz,2041-07-17
6033,1428,4605,2012,7,18,xyz,2041-07-18
5405,9567,-4162,2012,7,19,xyz,2041-07-19
7520,7751,-231,2012,7,20,xyz,2041-07-20
6483,6840,-357,2012,7,21,xyz,2041-07-21
3487,2784,703,2012,7,22,xyz,2041-07-22
2989,2893,96,2012,7,23,xyz,2041-07-23
6584,6267,317,2012,7,24,xyz,2041-07-24
3262,2119,1143,2012,7,25,xyz,2041-07-25
9261,9130,131,2012,7,26,xyz,2041-07-26
6953,3091,3862,2012,7,27,xyz,2041-07-27
3469,7100,-3631,2012,7,28,xyz,2041-07-28
8675,4534,4141,2012,7,29,xyz,2041-07-29
1891,8076,-6185,2012,7,30,xyz,2041-07-30
9472,1733,7739,2012,7,31,xyz,2041-07-31
3595,4323,-728,2012,8,1,xyz,2041-08-01
2372,1971,401,2012,8,2,xyz,2041-08-02
8010,2568,5442,2012,8,3,xyz,2041-08-03
1517,7657,-6140,2012,8,4,xyz,2041-08-04
1652,4299,-2647,2012,8,5,xyz,2041-08-05
2615,7205,-4590,2012,8,6,xyz,2041-08-06
8680,4788,3892,2012,8,7,xyz,2041-08-07
2106,4110,-2004,2012,8,8,xyz,2041-08-08
1976,6574,-4598,2012,8,9,xyz,2041-08-09
4927,6965,-2038,2012,8,10,xyz,2041-08-10
4097,7092,-2995,2012,8,11,xyz,2041-08-11
4265,5657,-1392,2012,8,12,xyz,2041-08-12
1561,9262,-7701,2012,8,13,xyz,2041-08-13
3900,7055,-3155,2012,8,14,xyz,2041-08-14
3362,9335,-5973,2012,8,15,xyz,2041-08-15
5121,2932,2189,2012,8,16,xyz,2041-08-16
8839,2780,6059,2012,8,17,xyz,2041-08-17
5772,6185,-413,2012,8,18,xyz,2041-08-18
3504,1369,2135,2012,8,19,xyz,2041-08-19
4975,9486,-4511,2012,8,20,xyz,2041-08-20
3597,9034,-5437,2012,8,21,xyz,2041-08-21
4806,772,4034,2012,8,22,xyz,2041-08-22
9046,3337,5709,2012,8,23,xyz,2041-08-23
7106,9728,-2622,2012,8,24,xyz,2041-08-24
3525,8115,-4590,2012,8,25,xyz,2041-08-25
8143,1326,6817,2012,8,26,xyz,2041-08-26
9428,5445,3983,2012,8,27,xyz,2041-08-27
5891,8375,-2484,2012,8,28,xyz,2041-08-28
1041,9671,-8630,2012,8,29,xyz,2041-08-29
3307,1446,1861,2012,8,30,xyz,2041-08-30
9278,4435,4843,2012,8,31,xyz,2041-08-31
3107,6482,-3375,2012,9,1,xyz,2041-09-01
2703,4862,-2159,2012,9,2,xyz,2041-09-02
5112,6165,-1053,2012,9,3,xyz,2041-09-03
4698,2027,2671,2012,9,4,xyz,2041-09-04
3369,2789,580,2012,9,5,xyz,2041-09-05
6651,3712,2939,2012,9,6,xyz,2041-09-06
3439,5573,-2134,2012,9,7,xyz,2041-09-07
1217,9844,-8627,2012,9,8,xyz,2041-09-08
5670,5636,34,2012,9,9,xyz,2041-09-09
2908,1670,1238,2012,9,10,xyz,2041-09-10
5572,1425,4147,2012,9,11,xyz,2041-09-11
9553,8160,1393,2012,9,12,xyz,2041-09-12
9066,4794,4272,2012,9,13,xyz,2041-09-13
6162,9789,-3627,2012,9,14,xyz,2041-09-14
1367,5897,-4530,2012,9,15,xyz,2041-09-15
5752,8100,-2348,2012,9,16,xyz,2041-09-16
5494,6506,-1012,2012,9,17,xyz,2041-09-17
3137,984,2153,2012,9,18,xyz,2041-09-18
5845,3433,2412,2012,9,19,xyz,2041-09-19
3021,5562,-2541,2012,9,20,xyz,2041-09-20
5579,6250,-671,2012,9,21,xyz,2041-09-21
2928,7815,-4887,2012,9,22,xyz,2041-09-22
2480,3932,-1452,2012,9,23,xyz,2041-09-23
3199,5819,-2620,2012,9,24,xyz,2041-09-24
6840,2556,4284,2012,9,25,xyz,2041-09-25
6871,7675,-804,2012,9,26,xyz,2041-09-26
7600,6279,1321,2012,9,27,xyz,2041-09-27
3120,9099,-5979,2012,9,28,xyz,2041-09-28
6609,7929,-1320,2012,9,29,xyz,2041-09-29
1935,5026,-3091,2012,9,30,xyz,2041-09-30
7014,9135,-2121,2012,10,1,xyz,2041-10-01
1246,1107,139,2012,10,2,xyz,2041-10-02
1009,5403,-4394,2012,10,3,xyz,2041-10-03
9072,9881,-809,2012,10,4,xyz,2041-10-04
4790,990,3800,2012,10,5,xyz,2041-10-05
5722,7254,-1532,2012,10,6,xyz,2041-10-06
5485,2469,3016,2012,10,7,xyz,2041-10-07
5705,7523,-1818,2012,10,8,xyz,2041-10-08
1438,8543,-7105,2012,10,9,xyz,2041-10-09
9773,6755,3018,2012,10,10,xyz,2041-10-10
9434,2559,6875,2012,10,11,xyz,2041-10-11
2114,4365,-2251,2012,10,12,xyz,2041-10-12
7165,8669,-1504,2012,10,13,xyz,2041-10-13
9093,3293,5800,2012,10,14,xyz,2041-10-14
9318,3939,5379,2012,10,15,xyz,2041-10-15
6778,1232,5546,2012,10,16,xyz,2041-10-16
8114,8704,-590,2012,10,17,xyz,2041-10-17
5354,4983,371,2012,10,18,xyz,2041-10-18
7644,3937,3707,2012,10,19,xyz,2041-10-19
8423,9529,-1106,2012,10,20,xyz,2041-10-20
3873,4516,-643,2012,10,21,xyz,2041-10-21
1610,2486,-876,2012,10,22,xyz,2041-10-22
1603,7771,-6168,2012,10,23,xyz,2041-10-23
4849,5917,-1068,2012,10,24,xyz,2041-10-24
9843,3849,5994,2012,10,25,xyz,2041-10-25
6491,7400,-909,2012,10,26,xyz,2041-10-26
1106,9869,-8763,2012,10,27,xyz,2041-10-27
1201,4676,-3475,2012,10,28,xyz,2041-10-28
3450,600,2850,2012,10,29,xyz,2041-10-29
4652,2944,1708,2012,10,30,xyz,2041-10-30
1516,4166,-2650,2012,10,31,xyz,2041-10-31
8882,1712,7170,2012,11,1,xyz,2041-11-01
2187,9301,-7114,2012,11,2,xyz,2041-11-02
5565,5297,268,2012,11,3,xyz,2041-11-03
5347,9269,-3922,2012,11,4,xyz,2041-11-04
8282,3604,4678,2012,11,5,xyz,2041-11-05
5801,1963,3838,2012,11,6,xyz,2041-11-06
5450,1810,3640,2012,11,7,xyz,2041-11-07
6966,5316,1650,2012,11,8,xyz,2041-11-08
8508,709,7799,2012,11,9,xyz,2041-11-09
6062,7221,-1159,2012,11,10,xyz,2041-11-10
3339,7918,-4579,2012,11,11,xyz,2041-11-11
2448,6142,-3694,2012,11,12,xyz,2041-11-12
4875,3643,1232,2012,11,13,xyz,2041-11-13
5514,1504,4010,2012,11,14,xyz,2041-11-14
2154,2124,30,2012,11,15,xyz,2041-11-15
5208,7939,-2731,2012,11,16,xyz,2041-11-16
4240,2315,1925,2012,11,17,xyz,2041-11-17
7146,6725,421,2012,11,18,xyz,2041-11-18
5501,1017,4484,2012,11,19,xyz,2041-11-19
1147,1978,-831,2012,11,20,xyz,2041-11-20
5230,2281,2949,2012,11,21,xyz,2041-11-21
7609,1091,6518,2012,11,22,xyz,2041-11-22
2966,4449,-1483,2012,11,23,xyz,2041-11-23
7813,2830,4983,2012,11,24,xyz,2041-11-24
5473,7781,-2308,2012,11,25,xyz,2041-11-25
6389,838,5551,2012,11,26,xyz,2041-11-26
9074,8714,360,2012,11,27,xyz,2041-11-27
2377,3578,-1201,2012,11,28,xyz,2041-11-28
6800,9369,-2569,2012,11,29,xyz,2041-11-29
4383,647,3736,2012,11,30,xyz,2041-11-30
5735,9854,-4119,2012,12,1,xyz,2041-12-01
6153,9291,-3138,2012,12,2,xyz,2041-12-02
7950,5395,2555,2012,12,3,xyz,2041-12-03
2461,7094,-4633,2012,12,4,xyz,2041-12-04
4419,2487,1932,2012,12,5,xyz,2041-12-05
8600,3100,5500,2012,12,6,xyz,2041-12-06
3599,5342,-1743,2012,12,7,xyz,2041-12-07
3220,1392,1828,2012,12,8,xyz,2041-12-08
5015,4258,757,2012,12,9,xyz,2041-12-09
3628,7083,-3455,2012,12,10,xyz,2041-12-10
9421,1017,8404,2012,12,11,xyz,2041-12-11
4195,8693,-4498,2012,12,12,xyz,2041-12-12
3498,8711,-5213,2012,12,13,xyz,2041-12-13
8134,5885,2249,2012,12,14,xyz,2041-12-14
9285,3035,6250,2012,12,15,xyz,2041-12-15
4154,6497,-2343,2012,12,16,xyz,2041-12-16
2028,3866,-1838,2012,12,17,xyz,2041-12-17
1305,2090,-785,2012,12,18,xyz,2041-12-18
9302,1452,7850,2012,12,19,xyz,2041-12-19
4121,3633,488,2012,12,20,xyz,2041-12-20
5350,2168,3182,2012,12,21,xyz,2041-12-21
2035,8470,-6435,2012,12,22,xyz,2041-12-22
4870,6452,-1582,2012,12,23,xyz,2041-12-23
5905,538,5367,2012,12,24,xyz,2041-12-24
2500,2208,292,2012,12,25,xyz,2041-12-25
2746,5650,-2904,2012,12,26,xyz,2041-12-26
7408,1275,6133,2012,12,27,xyz,2041-12-27
8574,2535,6039,2012,12,28,xyz,2041-12-28
6484,8563,-2079,2012,12,29,xyz,2041-12-29
3717,8555,-4838,2012,12,30,xyz,2041-12-30
2393,6481,-4088,2012,12,31,xyz,2041-12-31
4801,2792,2009,2013,1,1,xyz,2042-01-01
9148,4576,4572,2013,1,2,xyz,2042-01-02
6704,6577,127,2013,1,3,xyz,2042-01-03
6835,5238,1597,2013,1,4,xyz,2042-01-04
1688,3508,-1820,2013,1,5,xyz,2042-01-05
6270,1173,5097,2013,1,6,xyz,2042-01-06
6024,3887,2137,2013,1,7,xyz,2042-01-07
4210,8198,-3988,2013,1,8,xyz,2042-01-08
2166,2146,20,2013,1,9,xyz,2042-01-09
5788,3413,2375,2013,1,10,xyz,2042-01-10
9986,3136,6850,2013,1,11,xyz,2042-01-11
5854,4821,1033,2013,1,12,xyz,2042-01-12
3142,2269,873,2013,1,13,xyz,2042-01-13
8232,5680,2552,2013,1,14,xyz,2042-01-14
4743,8174,-3431,2013,1,15,xyz,2042-01-15
4966,2588,2378,2013,1,16,xyz,2042-01-16
8220,2955,5265,2013,1,17,xyz,2042-01-17
9261,9538,-277,2013,1,18,xyz,2042-01-18
6648,6590,58,2013,1,19,xyz,2042-01-19
9786,6859,2927,2013,1,20,xyz,2042-01-20
3006,9570,-6564,2013,1,21,xyz,2042-01-21
6584,5918,666,2013,1,22,xyz,2042-01-22
5131,4395,736,2013,1,23,xyz,2042-01-23
7467,1276,6191,2013,1,24,xyz,2042-01-24
9338,4887,4451,2013,1,25,xyz,2042-01-25
2030,7256,-5226,2013,1,26,xyz,2042-01-26
2322,8077,-5755,2013,1,27,xyz,2042-01-27
7381,7254,127,2013,1,28,xyz,2042-01-28
7192,8373,-1181,2013,1,29,xyz,2042-01-29
5815,2511,3304,2013,1,30,xyz,2042-01-30
7099,4031,3068,2013,1,31,xyz,2042-01-31
9903,3793,6110,2013,2,1,xyz,2042-02-01
1585,1178,407,2013,2,2,xyz,2042-02-02
5460,7535,-2075,2013,2,3,xyz,2042-02-03
2570,3112,-542,2013,2,4,xyz,2042-02-04
5507,9489,-3982,2013,2,5,xyz,2042-02-05
2632,4005,-1373,2013,2,6,xyz,2042-02-06
4529,1729,2800,2013,2,7,xyz,2042-02-07
5173,6229,-1056,2013,2,8,xyz,2042-02-08
7035,2752,4283,2013,2,9,xyz,2042-02-09
5088,7768,-2680,2013,2,10,xyz,2042-02-10
9530,2505,7025,2013,2,11,xyz,2042-02-11
9203,8022,1181,2013,2,12,xyz,2042-02-12
3130,4726,-1596,2013,2,13,xyz,2042-02-13
5851,4666,1185,2013,2,14,xyz,2042-02-14
6517,2620,3897,2013,2,15,xyz,2042-02-15
1998,2457,-459,2013,2,16,xyz,2042-02-16
5132,5777,-645,2013,2,17,xyz,2042-02-17
8091,9467,-1376,2013,2,18,xyz,2042-02-18
9529,5670,3859,2013,2,19,xyz,2042-02-19
7216,6570,646,2013,2,20,xyz,2042-02-20
4149,6413,-2264,2013,2,21,xyz,2042-02-21
2365,4936,-2571,2013,2,22,xyz,2042-02-22
5909,6801,-892,2013,2,23,xyz,2042-02-23
4613,779,3834,2013,2,24,xyz,2042-02-24
3349,6818,-3469,2013,2,25,xyz,2042-02-25
6537,6133,404,2013,2,26,xyz,2042-02-26
4348,8647,-4299,2013,2,27,xyz,2042-02-27
7339,9896,-2557,2013,2,28,xyz,2042-02-28
4894,3586,1308,2013,3,1,xyz,2042-03-01
3117,5790,-2673,2013,3,2,xyz,2042-03-02
7539,4653,2886,2013,3,3,xyz,2042-03-03
2505,3879,-1374,2013,3,4,xyz,2042-03-04
5125,7623,-2498,2013,3,5,xyz,2042-03-05
7474,7119,355,2013,3,6,xyz,2042-03-06
9561,1930,7631,2013,3,7,xyz,2042-03-07
8949,2519,6430,2013,3,8,xyz,2042-03-08
5819,8495,-2676,2013,3,9,xyz,2042-03-09
4934,2324,2610,2013,3,10,xyz,2042-03-10
4473,1767,2706,2013,3,11,xyz,2042-03-11
2096,987,1109,2013,3,12,xyz,2042-03-12
5510,7709,-2199,2013,3,13,xyz,2042-03-13
9610,2738,6872,2013,3,14,xyz,2042-03-14
2346,3810,-1464,2013,3,15,xyz,2042-03-15
9187,2835,6352,2013,3,16,xyz,2042-03-16
8922,3128,5794,2013,3,17,xyz,2042-03-17
8639,1348,7291,2013,3,18,xyz,2042-03-18
5378,3960,1418,2013,3,19,xyz,2042-03-19
9705,5832,3873,2013,3,20,xyz,2042-03-20
8722,8040,682,2013,3,21,xyz,2042-03-21
1032,4427,-3395,2013,3,22,xyz,2042-03-22
4851,4934,-83,2013,3,23,xyz,2042-03-23
7842,5022,2820,2013,3,24,xyz,2042-03-24
8800,6833,1967,2013,3,25,xyz,2042-03-25
8858,4920,3938,2013,3,26,xyz,2042-03-26
5280,6140,-860,2013,3,27,xyz,2042-03-27
3587,3488,99,2013,3,28,xyz,2042-03-28
7186,6802,384,2013,3,29,xyz,2042-03-29
2824,9598,-6774,2013,3,30,xyz,2042-03-30
3882,4691,-809,2013,3,31,xyz,2042-03-31
3418,5870,-2452,2013,4,1,xyz,2042-04-01
6505,1729,4776,2013,4,2,xyz,2042-04-02
3516,3003,513,2013,4,3,xyz,2042-04-03
5810,5423,387,2013,4,4,xyz,2042-04-04
3285,4201,-916,2013,4,5,xyz,2042-04-05
7083,6312,771,2013,4,6,xyz,2042-04-06
4088,8665,-4577,2013,4,7,xyz,2042-04-07
7887,3713,4174,2013,4,8,xyz,2042-04-08
9659,8467,1192,2013,4,9,xyz,2042-04-09
3891,1969,1922,2013,4,10,xyz,2042-04-10
8731,7529,1202,2013,4,11,xyz,2042-04-11
8953,9497,-544,2013,4,12,xyz,2042-04-12
6187,6109,78,2013,4,13,xyz,2042-04-13
9827,738,9089,2013,4,14,xyz,2042-04-14
9480,2573,6907,2013,4,15,xyz,2042-04-15
8610,4910,3700,2013,4,16,xyz,2042-04-16
7897,3541,4356,2013,4,17,xyz,2042-04-17
9276,9282,-6,2013,4,18,xyz,2042-04-18
2445,2548,-103,2013,4,19,xyz,2042-04-19
3145,4349,-1204,2013,4,20,xyz,2042-04-20
1149,3159,-2010,2013,4,21,xyz,2042-04-21
9525,6149,3376,2013,4,22,xyz,2042-04-22
8209,1711,6498,2013,4,23,xyz,2042-04-23
3541,8935,-5394,2013,4,24,xyz,2042-04-24
4950,6100,-1150,2013,4,25,xyz,2042-04-25
5357,7888,-2531,2013,4,26,xyz,2042-04-26
3254,8232,-4978,2013,4,27,xyz,2042-04-27
7829,3022,4807,2013,4,28,xyz,2042-04-28
4834,3504,1330,2013,4,29,xyz,2042-04-29
3697,9823,-6126,2013,4,30,xyz,2042-04-30
3940,5982,-2042,2013,5,1,xyz,2042-05-01
3125,5266,-2141,2013,5,2,xyz,2042-05-02
8782,6680,2102,2013,5,3,xyz,2042-05-03
4643,6557,-1914,2013,5,4,xyz,2042-05-04
8128,2349,5779,2013,5,5,xyz,2042-05-05
8886,5318,3568,2013,5,6,xyz,2042-05-06
8838,5587,3251,2013,5,7,xyz,2042-05-07
1060,912,148,2013,5,8,xyz,2042-05-08
1596,539,1057,2013,5,9,xyz,2042-05-09
2262,8987,-6725,2013,5,10,xyz,2042-05-10
5856,9986,-4130,2013,5,11,xyz,2042-05-11
3605,3181,424,2013,5,12,xyz,2042-05-12
1852,2568,-716,2013,5,13,xyz,2042-05-13
8233,6246,1987,2013,5,14,xyz,2042-05-14
7322,2880,4442,2013,5,15,xyz,2042-05-15
3417,4413,-996,2013,5,16,xyz,2042-05-16
5727,9091,-3364,2013,5,17,xyz,2042-05-17
8806,5159,3647,2013,5,18,xyz,2042-05-18
7921,8315,-394,2013,5,19,xyz,2042-05-19
3482,9934,-6452,2013,5,20,xyz,2042-05-20
9879,6319,3560,2013,5,21,xyz,2042-05-21
5334,5612,-278,2013,5,22,xyz,2042-05-22
2916,5460,-2544,2013,5,23,xyz,2042-05-23
2687,9696,-7009,2013,5,24,xyz,2042-05-24
3541,6072,-2531,2013,5,25,xyz,2042-05-25
6990,7343,-353,2013,5,26,xyz,2042-05-26
2243,3500,-1257,2013,5,27,xyz,2042-05-27
4339,7423,-3084,2013,5,28,xyz,2042-05-28
3551,7660,-4109,2013,5,29,xyz,2042-05-29
7369,2168,5201,2013,5,30,xyz,2042-05-30
7435,9028,-1593,2013,5,31,xyz,2042-05-31
4695,4011,684,2013,6,1,xyz,2042-06-01
1847,9185,-7338,2013,6,2,xyz,2042-06-02
1843,8681,-6838,2013,6,3,xyz,2042-06-03
6748,5735,1013,2013,6,4,xyz,2042-06-04
1609,6751,-5142,2013,6,5,xyz,2042-06-05
8004,8174,-170,2013,6,6,xyz,2042-06-06
1183,7614,-6431,2013,6,7,xyz,2042-06-07
8660,8573,87,2013,6,8,xyz,2042-06-08
7408,9269,-1861,2013,6,9,xyz,2042-06-09
9454,7884,1570,2013,6,10,xyz,2042-06-10
8401,3297,5104,2013,6,11,xyz,2042-06-11
5483,9996,-4513,2013,6,12,xyz,2042-06-12
4164,710,3454,2013,6,13,xyz,2042-06-13
1337,3912,-2575,2013,6,14,xyz,2042-06-14
6716,6325,391,2013,6,15,xyz,2042-06-15
4191,1101,3090,2013,6,16,xyz,2042-06-16
9941,3046,6895,2013,6,17,xyz,2042-06-17
9765,8454,1311,2013,6,18,xyz,2042-06-18
7757,4037,3720,2013,6,19,xyz,2042-06-19
5835,5460,375,2013,6,20,xyz,2042-06-20
7272,1441,5831,2013,6,21,xyz,2042-06-21
4936,2020,2916,2013,6,22,xyz,2042-06-22
8367,588,7779,2013,6,23,xyz,2042-06-23
2602,5893,-3291,2013,6,24,xyz,2042-06-24
1883,7165,-5282,2013,6,25,xyz,2042-06-25
3790,3982,-192,2013,6,26,xyz,2042-06-26
3645,6224,-2579,2013,6,27,xyz,2042-06-27
7173,7924,-751,2013,6,28,xyz,2042-06-28
3201,7011,-3810,2013,6,29,xyz,2042-06-29
6723,6258,465,2013,6,30,xyz,2042-06-30
7064,5438,1626,2013,7,1,xyz,2042-07-01
3060,917,2143,2013,7,2,xyz,2042-07-02
8835,2462,6373,2013,7,3,xyz,2042-07-03
7548,1786,5762,2013,7,4,xyz,2042-07-04
2842,2950,-108,2013,7,5,xyz,2042-07-05
6471,1133,5338,2013,7,6,xyz,2042-07-06
3316,6617,-3301,2013,7,7,xyz,2042-07-07
5275,9484,-4209,2013,7,8,xyz,2042-07-08
1339,7855,-6516,2013,7,9,xyz,2042-07-09
3722,6950,-3228,2013,7,10,xyz,2042-07-10
4653,9610,-4957,2013,7,11,xyz,2042-07-11
4401,3043,1358,2013,7,12,xyz,2042-07-12
1836,8086,-6250,2013,7,13,xyz,2042-07-13
8037,9907,-1870,2013,7,14,xyz,2042-07-14
2804,6995,-4191,2013,7,15,xyz,2042-07-15
8657,2322,6335,2013,7,16,xyz,2042-07-16
3493,9587,-6094,2013,7,17,xyz,2042-07-17
7414,9897,-2483,2013,7,18,xyz,2042-07-18
1635,1966,-331,2013,7,19,xyz,2042-07-19
5821,6087,-266,2013,7,20,xyz,2042-07-20
9035,9659,-624,2013,7,21,xyz,2042-07-21
6783,8965,-2182,2013,7,22,xyz,2042-07-22
7803,2509,5294,2013,7,23,xyz,2042-07-23
9850,2774,7076,2013,7,24,xyz,2042-07-24
3108,9609,-6501,2013,7,25,xyz,2042-07-25
7736,3789,3947,2013,7,26,xyz,2042-07-26
1353,6293,-4940,2013,7,27,xyz,2042-07-27
4387,5178,-791,2013,7,28,xyz,2042-07-28
6490,6061,429,2013,7,29,xyz,2042-07-29
2686,8962,-6276,2013,7,30,xyz,2042-07-30
8749,3331,5418,2013,7,31,xyz,2042-07-31
7022,1803,5219,2013,8,1,xyz,2042-08-01
2669,7723,-5054,2013,8,2,xyz,2042-08-02
5114,9930,-4816,2013,8,3,xyz,2042-08-03
9921,3639,6282,2013,8,4,xyz,2042-08-04
6567,7531,-964,2013,8,5,xyz,2042-08-05
7651,6016,1635,2013,8,6,xyz,2042-08-06
7838,5514,2324,2013,8,7,xyz,2042-08-07
6778,2033,4745,2013,8,8,xyz,2042-08-08
1738,4202,-2464,2013,8,9,xyz,2042-08-09
4473,8264,-3791,2013,8,10,xyz,2042-08-10
9728,6932,2796,2013,8,11,xyz,2042-08-11
8069,9614,-1545,2013,8,12,xyz,2042-08-12
6431,3531,2900,2013,8,13,xyz,2042-08-13
1179,7926,-6747,2013,8,14,xyz,2042-08-14
1574,7838,-6264,2013,8,15,xyz,2042-08-15
6338,7323,-985,2013,8,16,xyz,2042-08-16
4810,4878,-68,2013,8,17,xyz,2042-08-17
3739,4503,-764,2013,8,18,xyz,2042-08-18
5927,7249,-1322,2013,8,19,xyz,2042-08-19
7924,8794,-870,2013,8,20,xyz,2042-08-20
5594,6034,-440,2013,8,21,xyz,2042-08-21
5516,7952,-2436,2013,8,22,xyz,2042-08-22
4705,4614,91,2013,8,23,xyz,2042-08-23
2351,1002,1349,2013,8,24,xyz,2042-08-24
2556,7013,-4457,2013,8,25,xyz,2042-08-25
4744,703,4041,2013,8,26,xyz,2042-08-26
9447,8681,766,2013,8,27,xyz,2042-08-27
2323,4113,-1790,2013,8,28,xyz,2042-08-28
8606,567,8039,2013,8,29,xyz,2042-08-29
7228,1700,5528,2013,8,30,xyz,2042-08-30
9525,2975,6550,2013,8,31,xyz,2042-08-31
4934,3560,1374,2013,9,1,xyz,2042-09-01
3424,3790,-366,2013,9,2,xyz,2042-09-02
3812,6043,-2231,2013,9,3,xyz,2042-09-03
1742,1846,-104,2013,9,4,xyz,2042-09-04
1155,2745,-1590,2013,9,5,xyz,2042-09-05
9538,6339,3199,2013,9,6,xyz,2042-09-06
8089,6680,1409,2013,9,7,xyz,2042-09-07
1952,6951,-4999,2013,9,8,xyz,2042-09-08
8066,7297,769,2013,9,9,xyz,2042-09-09
3302,8846,-5544,2013,9,10,xyz,2042-09-10
3565,2549,1016,2013,9,11,xyz,2042-09-11
4330,2588,1742,2013,9,12,xyz,2042-09-12
6543,8054,-1511,2013,9,13,xyz,2042-09-13
5850,5907,-57,2013,9,14,xyz,2042-09-14
9646,5158,4488,2013,9,15,xyz,2042-09-15
4730,1803,2927,2013,9,16,xyz,2042-09-16
7403,5968,1435,2013,9,17,xyz,2042-09-17
1217,9998,-8781,2013,9,18,xyz,2042-09-18
7312,2782,4530,2013,9,19,xyz,2042-09-19
1258,5932,-4674,2013,9,20,xyz,2042-09-20
1087,2973,-1886,2013,9,21,xyz,2042-09-21
2441,4927,-2486,2013,9,22,xyz,2042-09-22
2502,528,1974,2013,9,23,xyz,2042-09-23
2245,8617,-6372,2013,9,24,xyz,2042-09-24
9333,2664,6669,2013,9,25,xyz,2042-09-25
8581,8111,470,2013,9,26,xyz,2042-09-26
3613,8060,-4447,2013,9,27,xyz,2042-09-27
2135,5895,-3760,2013,9,28,xyz,2042-09-28
7454,2946,4508,2013,9,29,xyz,2042-09-29
1873,2789,-916,2013,9,30,xyz,2042-09-30
8945,6347,2598,2013,10,1,xyz,2042-10-01
1058,7854,-6796,2013,10,2,xyz,2042-10-02
7152,5143,2009,2013,10,3,xyz,2042-10-03
3847,3074,773,2013,10,4,xyz,2042-10-04
3489,4227,-738,2013,10,5,xyz,2042-10-05
5211,7675,-2464,2013,10,6,xyz,2042-10-06
6973,6809,164,2013,10,7,xyz,2042-10-07
9554,6477,3077,2013,10,8,xyz,2042-10-08
7205,5275,1930,2013,10,9,xyz,2042-10-09
7740,1553,6187,2013,10,10,xyz,2042-10-10
7642,879,6763,2013,10,11,xyz,2042-10-11
7057,7923,-866,2013,10,12,xyz,2042-10-12
7886,3388,4498,2013,10,13,xyz,2042-10-13
3566,6741,-3175,2013,10,14,xyz,2042-10-14
5378,700,4678,2013,10,15,xyz,2042-10-15
6003,8334,-2331,2013,10,16,xyz,2042-10-16
3841,4563,-722,2013,10,17,xyz,2042-10-17
6523,9887,-3364,2013,10,18,xyz,2042-10-18
4331,750,3581,2013,10,19,xyz,2042-10-19
7356,1646,5710,2013,10,20,xyz,2042-10-20
1507,2511,-1004,2013,10,21,xyz,2042-10-21
3320,2584,736,2013,10,22,xyz,2042-10-22
4891,3109,1782,2013,10,23,xyz,2042-10-23
7538,2484,5054,2013,10,24,xyz,2042-10-24
4821,3399,1422,2013,10,25,xyz,2042-10-25
2826,3372,-546,2013,10,26,xyz,2042-10-26
3583,5249,-1666,2013,10,27,xyz,2042-10-27
4681,6471,-1790,2013,10,28,xyz,2042-10-28
9092,7870,1222,2013,10,29,xyz,2042-10-29
8443,8130,313,2013,10,30,xyz,2042-10-30
5635,7440,-1805,2013,10,31,xyz,2042-10-31
5143,3689,1454,2013,11,1,xyz,2042-11-01
4034,611,3423,2013,11,2,xyz,2042-11-02
8859,2700,6159,2013,11,3,xyz,2042-11-03
7540,7325,215,2013,11,4,xyz,2042-11-04
5787,1077,4710,2013,11,5,xyz,2042-11-05
2566,4385,-1819,2013,11,6,xyz,2042-11-06
8732,9297,-565,2013,11,7,xyz,2042-11-07
7069,8816,-1747,2013,11,8,xyz,2042-11-08
3262,9963,-6701,2013,11,9,xyz,2042-11-09
3378,4220,-842,2013,11,10,xyz,2042-11-10
7380,5379,2001,2013,11,11,xyz,2042-11-11
4445,7189,-2744,2013,11,12,xyz,2042-11-12
1143,4635,-3492,2013,11,13,xyz,2042-11-13
1080,7175,-6095,2013,11,14,xyz,2042-11-14
6514,1356,5158,2013,11,15,xyz,2042-11-15
5359,9460,-4101,2013,11,16,xyz,2042-11-16
8704,7007,1697,2013,11,17,xyz,2042-11-17
9145,889,8256,2013,11,18,xyz,2042-11-18
4205,5345,-1140,2013,11,19,xyz,2042-11-19
9774,1994,7780,2013,11,20,xyz,2042-11-20
1870,6825,-4955,2013,11,21,xyz,2042-11-21
6441,2062,4379,2013,11,22,xyz,2042-11-22
2973,5009,-2036,2013,11,23,xyz,2042-11-23
8378,2730,5648,2013,11,24,xyz,2042-11-24
5279,3498,1781,2013,11,25,xyz,2042-11-25
5678,5229,449,2013,11,26,xyz,2042-11-26
2606,2125,481,2013,11,27,xyz,2042-11-27
5250,2591,2659,2013,11,28,xyz,2042-11-28
4998,3298,1700,2013,11,29,xyz,2042-11-29
1052,2196,-1144,2013,11,30,xyz,2042-11-30
1780,5752,-3972,2013,12,1,xyz,2042-12-01
3831,8788,-4957,2013,12,2,xyz,2042-12-02
1318,2843,-1525,2013,12,3,xyz,2042-12-03
4106,5102,-996,2013,12,4,xyz,2042-12-04
3100,8440,-5340,2013,12,5,xyz,2042-12-05
7942,1281,6661,2013,12,6,xyz,2042-12-06
7393,9149,-1756,2013,12,7,xyz,2042-12-07
6508,7560,-1052,2013,12,8,xyz,2042-12-08
2357,3442,-1085,2013,12,9,xyz,2042-12-09
7334,3906,3428,2013,12,10,xyz,2042-12-10
5135,5444,-309,2013,12,11,xyz,2042-12-11
6599,4483,2116,2013,12,12,xyz,2042-12-12
6962,3422,3540,2013,12,13,xyz,2042-12-13
6794,6587,207,2013,12,14,xyz,2042-12-14
1590,9722,-8132,2013,12,15,xyz,2042-12-15
1513,7742,-6229,2013,12,16,xyz,2042-12-16
2830,2081,749,2013,12,17,xyz,2042-12-17
6301,7940,-1639,2013,12,18,xyz,2042-12-18
1263,1803,-540,2013,12,19,xyz,2042-12-19
6341,6679,-338,2013,12,20,xyz,2042-12-20
1453,6364,-4911,2013,12,21,xyz,2042-12-21
6512,7120,-608,2013,12,22,xyz,2042-12-22
1803,5974,-4171,2013,12,23,xyz,2042-12-23
5296,9475,-4179,2013,12,24,xyz,2042-12-24
7796,1133,6663,2013,12,25,xyz,2042-12-25
6025,1151,4874,2013,12,26,xyz,2042-12-26
4468,4864,-396,2013,12,27,xyz,2042-12-27
1950,2085,-135,2013,12,28,xyz,2042-12-28
5904,9903,-3999,2013,12,29,xyz,2042-12-29
4447,8612,-4165,2013,12,30,xyz,2042-12-30
2456,8078,-5622,2013,12,31,xyz,2042-12-31
7929,5736,2193,2014,1,1,xyz,2043-01-01
8921,5949,2972,2014,1,2,xyz,2043-01-02
4844,5090,-246,2014,1,3,xyz,2043-01-03
2988,3349,-361,2014,1,4,xyz,2043-01-04
9548,797,8751,2014,1,5,xyz,2043-01-05
6389,3351,3038,2014,1,6,xyz,2043-01-06
6708,1620,5088,2014,1,7,xyz,2043-01-07
5217,9953,-4736,2014,1,8,xyz,2043-01-08
2624,2871,-247,2014,1,9,xyz,2043-01-09
6545,4865,1680,2014,1,10,xyz,2043-01-10
9034,2998,6036,2014,1,11,xyz,2043-01-11
5998,9743,-3745,2014,1,12,xyz,2043-01-12
7803,4351,3452,2014,1,13,xyz,2043-01-13
6351,8359,-2008,2014,1,14,xyz,2043-01-14
3573,7774,-4201,2014,1,15,xyz,2043-01-15
5524,2101,3423,2014,1,16,xyz,2043-01-16
1938,9852,-7914,2014,1,17,xyz,2043-01-17
7298,6027,1271,2014,1,18,xyz,2043-01-18
1091,5738,-4647,2014,1,19,xyz,2043-01-19
9744,913,8831,2014,1,20,xyz,2043-01-20
5233,4972,261,2014,1,21,xyz,2043-01-21
6305,4686,1619,2014,1,22,xyz,2043-01-22
6007,7075,-1068,2014,1,23,xyz,2043-01-23
7036,2044,4992,2014,1,24,xyz,2043-01-24
3158,2827,331,2014,1,25,xyz,2043-01-25
1665,9516,-7851,2014,1,26,xyz,2043-01-26
5350,3984,1366,2014,1,27,xyz,2043-01-27
8572,5474,3098,2014,1,28,xyz,2043-01-28
9832,8510,1322,2014,1,29,xyz,2043-01-29
6119,5149,970,2014,1,30,xyz,2043-01-30
3124,855,2269,2014,1,31,xyz,2043-01-31
4612,5890,-1278,2014,2,1,xyz,2043-02-01
2578,8807,-6229,2014,2,2,xyz,2043-02-02
5867,9970,-4103,2014,2,3,xyz,2043-02-03
1842,9787,-7945,2014,2,4,xyz,2043-02-04
6930,2521,4409,2014,2,5,xyz,2043-02-05
4682,2663,2019,2014,2,6,xyz,2043-02-06
6777,5453,1324,2014,2,7,xyz,2043-02-07
5745,9142,-3397,2014,2,8,xyz,2043-02-08
2379,8183,-5804,2014,2,9,xyz,2043-02-09
3132,510,2622,2014,2,10,xyz,2043-02-10
3234,958,2276,2014,2,11,xyz,2043-02-11
9570,6156,3414,2014,2,12,xyz,2043-02-12
3518,7003,-3485,2014,2,13,xyz,2043-02-13
5487,7172,-1685,2014,2,14,xyz,2043-02-14
7622,4758,2864,2014,2,15,xyz,2043-02-15
1945,8357,-6412,2014,2,16,xyz,2043-02-16
6891,7213,-322,2014,2,17,xyz,2043-02-17
7648,5583,2065,2014,2,18,xyz,2043-02-18
2936,7418,-4482,2014,2,19,xyz,2043-02-19
7741,3162,4579,2014,2,20,xyz,2043-02-20
6460,4113,2347,2014,2,21,xyz,2043-02-21
9007,5179,3828,2014,2,22,xyz,2043-02-22
5389,9014,-3625,2014,2,23,xyz,2043-02-23
2182,6617,-4435,2014,2,24,xyz,2043-02-24
9970,3604,6366,2014,2,25,xyz,2043-02-25
3329,4977,-1648,2014,2,26,xyz,2043-02-26
2076,1798,278,2014,2,27,xyz,2043-02-27
3054,9279,-6225,2014,2,28,xyz,2043-02-28
5499,5578,-79,2014,3,1,xyz,2043-03-01
1443,4337,-2894,2014,3,2,xyz,2043-03-02
4617,6938,-2321,2014,3,3,xyz,2043-03-03
6752,4722,2030,2014,3,4,xyz,2043-03-04
6340,5068,1272,2014,3,5,xyz,2043-03-05
4055,6432,-2377,2014,3,6,xyz,2043-03-06
2418,2719,-301,2014,3,7,xyz,2043-03-07
9001,7188,1813,2014,3,8,xyz,2043-03-08
2123,9817,-7694,2014,3,9,xyz,2043-03-09
1817,6188,-4371,2014,3,10,xyz,2043-03-10
5660,6042,-382,2014,3,11,xyz,2043-03-11
9183,7070,2113,2014,3,12,xyz,2043-03-12
8706,9336,-630,2014,3,13,xyz,2043-03-13
5416,7710,-2294,2014,3,14,xyz,2043-03-14
6579,7289,-710,2014,3,15,xyz,2043-03-15
9844,4976,4868,2014,3,16,xyz,2043-03-16
6974,5638,1336,2014,3,17,xyz,2043-03-17
7963,7816,147,2014,3,18,xyz,2043-03-18
9190,4352,4838,2014,3,19,xyz,2043-03-19
1745,5006,-3261,2014,3,20,xyz,2043-03-20
9996,7046,2950,2014,3,21,xyz,2043-03-21
1013,5677,-4664,2014,3,22,xyz,2043-03-22
5137,1126,4011,2014,3,23,xyz,2043-03-23
3435,1510,1925,2014,3,24,xyz,2043-03-24
2749,2018,731,2014,3,25,xyz,2043-03-25
9686,5507,4179,2014,3,26,xyz,2043-03-26
5908,7482,-1574,2014,3,27,xyz,2043-03-27
9574,2545,7029,2014,3,28,xyz,2043-03-28
6703,6544,159,2014,3,29,xyz,2043-03-29
6840,1382,5458,2014,3,30,xyz,2043-03-30
3377,6539,-3162,2014,3,31,xyz,2043-03-31
7196,3706,3490,2014,4,1,xyz,2043-04-01
4895,1110,3785,2014,4,2,xyz,2043-04-02
2481,6665,-4184,2014,4,3,xyz,2043-04-03
7695,9596,-1901,2014,4,4,xyz,2043-04-04
4291,3008,1283,2014,4,5,xyz,2043-04-05
5009,9957,-4948,2014,4,6,xyz,2043-04-06
4291,8653,-4362,2014,4,7,xyz,2043-04-07
3374,8344,-4970,2014,4,8,xyz,2043-04-08
7927,1653,6274,2014,4,9,xyz,2043-04-09
5577,9133,-3556,2014,4,10,xyz,2043-04-10
9003,550,8453,2014,4,11,xyz,2043-04-11
7093,7574,-481,2014,4,12,xyz,2043-04-12
8487,1892,6595,2014,4,13,xyz,2043-04-13
8680,2916,5764,2014,4,14,xyz,2043-04-14
7801,5563,2238,2014,4,15,xyz,2043-04-15
1655,5201,-3546,2014,4,16,xyz,2043-04-16
3992,4529,-537,2014,4,17,xyz,2043-04-17
5289,8680,-3391,2014,4,18,xyz,2043-04-18
2891,956,1935,2014,4,19,xyz,2043-04-19
7042,3129,3913,2014,4,20,xyz,2043-04-20
4855,3664,1191,2014,4,21,xyz,2043-04-21
3014,630,2384,2014,4,22,xyz,2043-04-22
2558,7055,-4497,2014,4,23,xyz,2043-04-23
5768,9825,-4057,2014,4,24,xyz,2043-04-24
3520,9157,-5637,2014,4,25,xyz,2043-04-25
8535,4944,3591,2014,4,26,xyz,2043-04-26
1876,1825,51,2014,4,27,xyz,2043-04-27
2117,4459,-2342,2014,4,28,xyz,2043-04-28
1846,6017,-4171,2014,4,29,xyz,2043-04-29
8883,2201,6682,2014,4,30,xyz,2043-04-30
8740,1877,6863,2014,5,1,xyz,2043-05-01
1288,4588,-3300,2014,5,2,xyz,2043-05-02
7393,940,6453,2014,5,3,xyz,2043-05-03
2561,7323,-4762,2014,5,4,xyz,2043-05-04
2916,2458,458,2014,5,5,xyz,2043-05-05
3128,1609,1519,2014,5,6,xyz,2043-05-06
1588,9098,-7510,2014,5,7,xyz,2043-05-07
3694,8539,-4845,2014,5,8,xyz,2043-05-08
6667,6854,-187,2014,5,9,xyz,2043-05-09
3637,9639,-6002,2014,5,10,xyz,2043-05-10
8442,5972,2470,2014,5,11,xyz,2043-05-11
7466,7303,163,2014,5,12,xyz,2043-05-12
4611,5966,-1355,2014,5,13,xyz,2043-05-13
7881,1992,5889,2014,5,14,xyz,2043-05-14
5859,6738,-879,2014,5,15,xyz,2043-05-15
3034,9881,-6847,2014,5,16,xyz,2043-05-16
5192,702,4490,2014,5,17,xyz,2043-05-17
5771,5997,-226,2014,5,18,xyz,2043-05-18
1088,4960,-3872,2014,5,19,xyz,2043-05-19
6416,4359,2057,2014,5,20,xyz,2043-05-20
2221,5733,-3512,2014,5,21,xyz,2043-05-21
2628,2059,569,2014,5,22,xyz,2043-05-22
8149,5110,3039,2014,5,23,xyz,2043-05-23
4608,5497,-889,2014,5,24,xyz,2043-05-24
2486,9124,-6638,2014,5,25,xyz,2043-05-25
9572,4839,4733,2014,5,26,xyz,2043-05-26
1100,2249,-1149,2014,5,27,xyz,2043-05-27
7407,6640,767,2014,5,28,xyz,2043-05-28
6569,9312,-2743,2014,5,29,xyz,2043-05-29
6176,5164,1012,2014,5,30,xyz,2043-05-30
1813,4992,-3179,2014,5,31,xyz,2043-05-31
3658,8420,-4762,2014,6,1,xyz,2043-06-01
3681,4129,-448,2014,6,2,xyz,2043-06-02
7558,6901,657,2014,6,3,xyz,2043-06-03
6554,8473,-1919,2014,6,4,xyz,2043-06-04
8313,2392,5921,2014,6,5,xyz,2043-06-05
2929,777,2152,2014,6,6,xyz,2043-06-06
1894,9069,-7175,2014,6,7,xyz,2043-06-07
2260,1956,304,2014,6,8,xyz,2043-06-08
3631,8692,-5061,2014,6,9,xyz,2043-06-09
6658,9701,-3043,2014,6,10,xyz,2043-06-10
7051,3838,3213,2014,6,11,xyz,2043-06-11
8180,984,7196,2014,6,12,xyz,2043-06-12
4050,8903,-4853,2014,6,13,xyz,2043-06-13
4647,4512,135,2014,6,14,xyz,2043-06-14
3350,6861,-3511,2014,6,15,xyz,2043-06-15
4607,1755,2852,2014,6,16,xyz,2043-06-16
4912,5565,-653,2014,6,17,xyz,2043-06-17
1916,9012,-7096,2014,6,18,xyz,2043-06-18
9035,6878,2157,2014,6,19,xyz,2043-06-19
3699,9726,-6027,2014,6,20,xyz,2043-06-20
9616,4513,5103,2014,6,21,xyz,2043-06-21
6146,9072,-2926,2014,6,22,xyz,2043-06-22
7864,3042,4822,2014,6,23,xyz,2043-06-23
4753,5718,-965,2014,6,24,xyz,2043-06-24
3332,8212,-4880,2014,6,25,xyz,2043-06-25
7670,5418,2252,2014,6,26,xyz,2043-06-26
2787,7646,-4859,2014,6,27,xyz,2043-06-27
9369,3544,5825,2014,6,28,xyz,2043-06-28
3005,6489,-3484,2014,6,29,xyz,2043-06-29
9963,9640,323,2014,6,30,xyz,2043-06-30
3962,5270,-1308,2014,7,1,xyz,2043-07-01
6479,9511,-3032,2014,7,2,xyz,2043-07-02
5070,5130,-60,2014,7,3,xyz,2043-07-03
8121,9051,-930,2014,7,4,xyz,2043-07-04
5970,5138,832,2014,7,5,xyz,2043-07-05
5778,2910,2868,2014,7,6,xyz,2043-07-06
7063,2282,4781,2014,7,7,xyz,2043-07-07
3897,6866,-2969,2014,7,8,xyz,2043-07-08
1900,3066,-1166,2014,7,9,xyz,2043-07-09
4265,2332,1933,2014,7,10,xyz,2043-07-10
8684,7151,1533,2014,7,11,xyz,2043-07-11
4477,6886,-2409,2014,7,12,xyz,2043-07-12
4004,3927,77,2014,7,13,xyz,2043-07-13
8489,6209,2280,2014,7,14,xyz,2043-07-14
9251,4846,4405,2014,7,15,xyz,2043-07-15
1775,8226,-6451,2014,7,16,xyz,2043-07-16
3878,8977,-5099,2014,7,17,xyz,2043-07-17
4118,7094,-2976,2014,7,18,xyz,2043-07-18
9455,2906,6549,2014,7,19,xyz,2043-07-19
4568,5620,-1052,2014,7,20,xyz,2043-07-20
3004,4104,-1100,2014,7,21,xyz,2043-07-21
9426,6134,3292,2014,7,22,xyz,2043-07-22
3147,6202,-3055,2014,7,23,xyz,2043-07-23
1505,8928,-7423,2014,7,24,xyz,2043-07-24
5624,5238,386,2014,7,25,xyz,2043-07-25
1526,914,612,2014,7,26,xyz,2043-07-26
7107,3671,3436,2014,7,27,xyz,2043-07-27
8391,9495,-1104,2014,7,28,xyz,2043-07-28
5975,816,5159,2014,7,29,xyz,2043-07-29
6694,5231,1463,2014,7,30,xyz,2043-07-30
9550,6477,3073,2014,7,31,xyz,2043-07-31
7498,4175,3323,2014,8,1,xyz,2043-08-01
7761,9411,-1650,2014,8,2,xyz,2043-08-02
1814,9464,-7650,2014,8,3,xyz,2043-08-03
7548,7582,-34,2014,8,4,xyz,2043-08-04
4610,1708,2902,2014,8,5,xyz,2043-08-05
4431,3949,482,2014,8,6,xyz,2043-08-06
5802,6578,-776,2014,8,7,xyz,2043-08-07
4024,6740,-2716,2014,8,8,xyz,2043-08-08
8389,2072,6317,2014,8,9,xyz,2043-08-09
6396,5874,522,2014,8,10,xyz,2043-08-10
3768,2320,1448,2014,8,11,xyz,2043-08-11
7822,5024,2798,2014,8,12,xyz,2043-08-12
1363,2468,-1105,2014,8,13,xyz,2043-08-13
1572,8982,-7410,2014,8,14,xyz,2043-08-14
4981,3004,1977,2014,8,15,xyz,2043-08-15
7954,2847,5107,2014,8,16,xyz,2043-08-16
8826,8718,108,2014,8,17,xyz,2043-08-17
9624,6867,2757,2014,8,18,xyz,2043-08-18
8377,3363,5014,2014,8,19,xyz,2043-08-19
3082,6310,-3228,2014,8,20,xyz,2043-08-20
6606,8154,-1548,2014,8,21,xyz,2043-08-21
7043,3680,3363,2014,8,22,xyz,2043-08-22
3197,5523,-2326,2014,8,23,xyz,2043-08-23
9742,6012,3730,2014,8,24,xyz,2043-08-24
4787,8627,-3840,2014,8,25,xyz,2043-08-25
2476,2555,-79,2014,8,26,xyz,2043-08-26
3801,4782,-981,2014,8,27,xyz,2043-08-27
7535,1935,5600,2014,8,28,xyz,2043-08-28
9471,1402,8069,2014,8,29,xyz,2043-08-29
9949,7087,2862,2014,8,30,xyz,2043-08-30
8212,8004,208,2014,8,31,xyz,2043-08-31
9714,8803,911,2014,9,1,xyz,2043-09-01
2497,5537,-3040,2014,9,2,xyz,2043-09-02
4181,9834,-5653,2014,9,3,xyz,2043-09-03
7223,8375,-1152,2014,9,4,xyz,2043-09-04
6699,4573,2126,2014,9,5,xyz,2043-09-05
6070,3958,2112,2014,9,6,xyz,2043-09-06
8701,4645,4056,2014,9,7,xyz,2043-09-07
5442,9232,-3790,2014,9,8,xyz,2043-09-08
9233,2563,6670,2014,9,9,xyz,2043-09-09
4371,7490,-3119,2014,9,10,xyz,2043-09-10
6937,9491,-2554,2014,9,11,xyz,2043-09-11
2493,8719,-6226,2014,9,12,xyz,2043-09-12
7867,1815,6052,2014,9,13,xyz,2043-09-13
9246,9073,173,2014,9,14,xyz,2043-09-14
8143,4948,3195,2014,9,15,xyz,2043-09-15
2845,1964,881,2014,9,16,xyz,2043-09-16
2094,9924,-7830,2014,9,17,xyz,2043-09-17
5214,4698,516,2014,9,18,xyz,2043-09-18
5967,4965,1002,2014,9,19,xyz,2043-09-19
3832,5025,-1193,2014,9,20,xyz,2043-09-20
8546,3819,4727,2014,9,21,xyz,2043-09-21
8945,7288,1657,2014,9,22,xyz,2043-09-22
6079,7209,-1130,2014,9,23,xyz,2043-09-23
3510,2275,1235,2014,9,24,xyz,2043-09-24
7342,5075,2267,2014,9,25,xyz,2043-09-25
7380,3640,3740,2014,9,26,xyz,2043-09-26
6407,2944,3463,2014,9,27,xyz,2043-09-27
3411,8152,-4741,2014,9,28,xyz,2043-09-28
5476,6595,-1119,2014,9,29,xyz,2043-09-29
9211,6264,2947,2014,9,30,xyz,2043-09-30
6859,1939,4920,2014,10,1,xyz,2043-10-01
8848,7794,1054,2014,10,2,xyz,2043-10-02
2263,4286,-2023,2014,10,3,xyz,2043-10-03
5204,3406,1798,2014,10,4,xyz,2043-10-04
2793,530,2263,2014,10,5,xyz,2043-10-05
7884,8057,-173,2014,10,6,xyz,2043-10-06
9906,1589,8317,2014,10,7,xyz,2043-10-07
9372,634,8738,2014,10,8,xyz,2043-10-08
7534,5979,1555,2014,10,9,xyz,2043-10-09
6103,5233,870,2014,10,10,xyz,2043-10-10
9903,8019,1884,2014,10,11,xyz,2043-10-11
6255,9346,-3091,2014,10,12,xyz,2043-10-12
1701,6689,-4988,2014,10,13,xyz,2043-10-13
1830,1866,-36,2014,10,14,xyz,2043-10-14
2358,2097,261,2014,10,15,xyz,2043-10-15
8523,3468,5055,2014,10,16,xyz,2043-10-16
4690,894,3796,2014,10,17,xyz,2043-10-17
4348,8341,-3993,2014,10,18,xyz,2043-10-18
8616,7929,687,2014,10,19,xyz,2043-10-19
3228,1152,2076,2014,10,20,xyz,2043-10-20
7376,6177,1199,2014,10,21,xyz,2043-10-21
6593,8475,-1882,2014,10,22,xyz,2043-10-22
3313,8763,-5450,2014,10,23,xyz,2043-10-23
3603,1920,1683,2014,10,24,xyz,2043-10-24
7291,3692,3599,2014,10,25,xyz,2043-10-25
7222,5350,1872,2014,10,26,xyz,2043-10-26
4942,5310,-368,2014,10,27,xyz,2043-10-27
4716,5075,-359,2014,10,28,xyz,2043-10-28
3842,2221,1621,2014,10,29,xyz,2043-10-29
4197,7893,-3696,2014,10,30,xyz,2043-10-30
4310,8973,-4663,2014,10,31,xyz,2043-10-31
2125,9101,-6976,2014,11,1,xyz,2043-11-01
9047,2416,6631,2014,11,2,xyz,2043-11-02
1946,1768,178,2014,11,3,xyz,2043-11-03
4603,5904,-1301,2014,11,4,xyz,2043-11-04
7323,7903,-580,2014,11,5,xyz,2043-11-05
9840,3763,6077,2014,11,6,xyz,2043-11-06
4209,939,3270,2014,11,7,xyz,2043-11-07
6218,4497,1721,2014,11,8,xyz,2043-11-08
5817,4683,1134,2014,11,9,xyz,2043-11-09
2932,9365,-6433,2014,11,10,xyz,2043-11-10
4096,9755,-5659,2014,11,11,xyz,2043-11-11
8947,6033,2914,2014,11,12,xyz,2043-11-12
7402,5612,1790,2014,11,13,xyz,2043-11-13
2070,1277,793,2014,11,14,xyz,2043-11-14
6450,4458,1992,2014,11,15,xyz,2043-11-15
2452,8390,-5938,2014,11,16,xyz,2043-11-16
7700,8437,-737,2014,11,17,xyz,2043-11-17
3238,3524,-286,2014,11,18,xyz,2043-11-18
4508,4552,-44,2014,11,19,xyz,2043-11-19
9560,2865,6695,2014,11,20,xyz,2043-11-20
7953,8680,-727,2014,11,21,xyz,2043-11-21
6929,2004,4925,2014,11,22,xyz,2043-11-22
7551,8584,-1033,2014,11,23,xyz,2043-11-23
9957,2625,7332,2014,11,24,xyz,2043-11-24
9884,866,9018,2014,11,25,xyz,2043-11-25
3490,5644,-2154,2014,11,26,xyz,2043-11-26
2257,9473,-7216,2014,11,27,xyz,2043-11-27
7928,8765,-837,2014,11,28,xyz,2043-11-28
9904,598,9306,2014,11,29,xyz,2043-11-29
3342,1220,2122,2014,11,30,xyz,2043-11-30
4769,9416,-4647,2014,12,1,xyz,2043-12-01
3868,5343,-1475,2014,12,2,xyz,2043-12-02
4520,5068,-548,2014,12,3,xyz,2043-12-03
6849,8288,-1439,2014,12,4,xyz,2043-12-04
2376,711,1665,2014,12,5,xyz,2043-12-05
4116,2007,2109,2014,12,6,xyz,2043-12-06
2460,2890,-430,2014,12,7,xyz,2043-12-07
3064,2869,195,2014,12,8,xyz,2043-12-08
5357,7395,-2038,2014,12,9,xyz,2043-12-09
7432,2223,5209,2014,12,10,xyz,2043-12-10
9261,2169,7092,2014,12,11,xyz,2043-12-11
2522,9774,-7252,2014,12,12,xyz,2043-12-12
5783,8111,-2328,2014,12,13,xyz,2043-12-13
1084,7492,-6408,2014,12,14,xyz,2043-12-14
3314,3116,198,2014,12,15,xyz,2043-12-15
2732,1427,1305,2014,12,16,xyz,2043-12-16
7949,1719,6230,2014,12,17,xyz,2043-12-17
5481,7194,-1713,2014,12,18,xyz,2043-12-18
9463,3941,5522,2014,12,19,xyz,2043-12-19
1371,713,658,2014,12,20,xyz,2043-12-20
4967,9320,-4353,2014,12,21,xyz,2043-12-21
8950,5742,3208,2014,12,22,xyz,2043-12-22
9668,9819,-151,2014,12,23,xyz,2043-12-23
3153,6402,-3249,2014,12,24,xyz,2043-12-24
9152,4323,4829,2014,12,25,xyz,2043-12-25
1433,6216,-4783,2014,12,26,xyz,2043-12-26
8214,4210,4004,2014,12,27,xyz,2043-12-27
3379,6124,-2745,2014,12,28,xyz,2043-12-28
1658,5958,-4300,2014,12,29,xyz,2043-12-29
5381,928,4453,2014,12,30,xyz,2043-12-30
2245,9225,-6980,2014,12,31,xyz,2043-12-31
2133,5852,-3719,2015,1,1,xyz,2044-01-01
2132,8169,-6037,2015,1,2,xyz,2044-01-02
5586,5483,103,2015,1,3,xyz,2044-01-03
1836,8727,-6891,2015,1,4,xyz,2044-01-04
6203,5684,519,2015,1,5,xyz,2044-01-05
7972,2180,5792,2015,1,6,xyz,2044-01-06
1335,8871,-7536,2015,1,7,xyz,2044-01-07
7901,1380,6521,2015,1,8,xyz,2044-01-08
6974,8567,-1593,2015,1,9,xyz,2044-01-09
5805,9051,-3246,2015,1,10,xyz,2044-01-10
7942,4044,3898,2015,1,11,xyz,2044-01-11
2972,7208,-4236,2015,1,12,xyz,2044-01-12
3388,6723,-3335,2015,1,13,xyz,2044-01-13
9606,8961,645,2015,1,14,xyz,2044-01-14
4199,8254,-4055,2015,1,15,xyz,2044-01-15
5307,4375,932,2015,1,16,xyz,2044-01-16
8218,9895,-1677,2015,1,17,xyz,2044-01-17
8801,8277,524,2015,1,18,xyz,2044-01-18
9729,3205,6524,2015,1,19,xyz,2044-01-19
1840,6715,-4875,2015,1,20,xyz,2044-01-20
2435,5515,-3080,2015,1,21,xyz,2044-01-21
7735,2058,5677,2015,1,22,xyz,2044-01-22
9343,5077,4266,2015,1,23,xyz,2044-01-23
3217,8244,-5027,2015,1,24,xyz,2044-01-24
8665,7259,1406,2015,1,25,xyz,2044-01-25
5846,4174,1672,2015,1,26,xyz,2044-01-26
3362,6979,-3617,2015,1,27,xyz,2044-01-27
6497,2951,3546,2015,1,28,xyz,2044-01-28
8930,8038,892,2015,1,29,xyz,2044-01-29
6086,9165,-3079,2015,1,30,xyz,2044-01-30
1615,1729,-114,2015,1,31,xyz,2044-01-31
3515,1193,2322,2015,2,1,xyz,2044-02-01
2487,3434,-947,2015,2,2,xyz,2044-02-02
2896,3485,-589,2015,2,3,xyz,2044-02-03
2811,2594,217,2015,2,4,xyz,2044-02-04
4188,7446,-3258,2015,2,5,xyz,2044-02-05
1252,9249,-7997,2015,2,6,xyz,2044-02-06
1088,3687,-2599,2015,2,7,xyz,2044-02-07
1102,1739,-637,2015,2,8,xyz,2044-02-08
5660,3000,2660,2015,2,9,xyz,2044-02-09
1683,5656,-3973,2015,2,10,xyz,2044-02-10
7565,3872,3693,2015,2,11,xyz,2044-02-11
7344,9937,-2593,2015,2,12,xyz,2044-02-12
3697,1929,1768,2015,2,13,xyz,2044-02-13
6891,2955,3936,2015,2,14,xyz,2044-02-14
3073,1370,1703,2015,2,15,xyz,2044-02-15
5394,635,4759,2015,2,16,xyz,2044-02-16
8910,6750,2160,2015,2,17,xyz,2044-02-17
1704,8649,-6945,2015,2,18,xyz,2044-02-18
3538,9944,-6406,2015,2,19,xyz,2044-02-19
8575,9549,-974,2015,2,20,xyz,2044-02-20
7645,4267,3378,2015,2,21,xyz,2044-02-21
1902,6549,-4647,2015,2,22,xyz,2044-02-22
5259,810,4449,2015,2,23,xyz,2044-02-23
4084,9305,-5221,2015,2,24,xyz,2044-02-24
8323,7335,988,2015,2,25,xyz,2044-02-25
6706,3929,2777,2015,2,26,xyz,2044-02-26
2465,6131,-3666,2015,2,27,xyz,2044-02-27
6374,8879,-2505,2015,2,28,xyz,2044-02-28
8652,7147,1505,2015,2,29,xyz,2044-02-29
8804,3152,5652,2015,3,1,xyz,2044-03-01
8778,1112,7666,2015,3,2,xyz,2044-03-02
9166,3350,5816,2015,3,3,xyz,2044-03-03
7792,2619,5173,2015,3,4,xyz,2044-03-04
2444,7885,-5441,2015,3,5,xyz,2044-03-05
7307,8296,-989,2015,3,6,xyz,2044-03-06
3414,2320,1094,2015,3,7,xyz,2044-03-07
6972,1863,5109,2015,3,8,xyz,2044-03-08
3630,3753,-123,2015,3,9,xyz,2044-03-09
6345,4170,2175,2015,3,10,xyz,2044-03-10
9288,4039,5249,2015,3,11,xyz,2044-03-11
5949,9067,-3118,2015,3,12,xyz,2044-03-12
6348,3992,2356,2015,3,13,xyz,2044-03-13
7193,1964,5229,2015,3,14,xyz,2044-03-14
5979,636,5343,2015,3,15,xyz,2044-03-15
6919,7030,-111,2015,3,16,xyz,2044-03-16
4901,1550,3351,2015,3,17,xyz,2044-03-17
4366,9321,-4955,2015,3,18,xyz,2044-03-18
8781,1678,7103,2015,3,19,xyz,2044-03-19
5235,9132,-3897,2015,3,20,xyz,2044-03-20
4004,9891,-5887,2015,3,21,xyz,2044-03-21
2213,1560,653,2015,3,22,xyz,2044-03-22
2245,948,1297,2015,3,23,xyz,2044-03-23
6272,8708,-2436,2015,3,24,xyz,2044-03-24
9068,2816,6252,2015,3,25,xyz,2044-03-25
7578,5907,1671,2015,3,26,xyz,2044-03-26
8533,2422,6111,2015,3,27,xyz,2044-03-27
1379,5986,-4607,2015,3,28,xyz,2044-03-28
7166,7373,-207,2015,3,29,xyz,2044-03-29
4057,7401,-3344,2015,3,30,xyz,2044-03-30
2981,9591,-6610,2015,3,31,xyz,2044-03-31
7458,1842,5616,2015,4,1,xyz,2044-04-01
2240,6113,-3873,2015,4,2,xyz,2044-04-02
8427,784,7643,2015,4,3,xyz,2044-04-03
6478,8927,-2449,2015,4,4,xyz,2044-04-04
1497,5328,-3831,2015,4,5,xyz,2044-04-05
8428,4304,4124,2015,4,6,xyz,2044-04-06
5029,1290,3739,2015,4,7,xyz,2044-04-07
3523,6465,-2942,2015,4,8,xyz,2044-04-08
6688,7242,-554,2015,4,9,xyz,2044-04-09
2536,1853,683,2015,4,10,xyz,2044-04-10
1994,2283,-289,2015,4,11,xyz,2044-04-11
1124,803,321,2015,4,12,xyz,2044-04-12
2794,1628,1166,2015,4,13,xyz,2044-04-13
2543,8531,-5988,2015,4,14,xyz,2044-04-14
7168,6094,1074,2015,4,15,xyz,2044-04-15
4596,5923,-1327,2015,4,16,xyz,2044-04-16
3715,9402,-5687,2015,4,17,xyz,2044-04-17
7749,7220,529,2015,4,18,xyz,2044-04-18
6036,3933,2103,2015,4,19,xyz,2044-04-19
1114,2095,-981,2015,4,20,xyz,2044-04-20
2596,619,1977,2015,4,21,xyz,2044-04-21
5030,8774,-3744,2015,4,22,xyz,2044-04-22
5855,4392,1463,2015,4,23,xyz,2044-04-23
8051,3639,4412,2015,4,24,xyz,2044-04-24
7859,4655,3204,2015,4,25,xyz,2044-04-25
9934,1658,8276,2015,4,26,xyz,2044-04-26
9084,505,8579,2015,4,27,xyz,2044-04-27
4086,4626,-540,2015,4,28,xyz,2044-04-28
6717,6892,-175,2015,4,29,xyz,2044-04-29
3039,3066,-27,2015,4,30,xyz,2044-04-30
1361,6639,-5278,2015,5,1,xyz,2044-05-01
2706,718,1988,2015,5,2,xyz,2044-05-02
4201,7100,-2899,2015,5,3,xyz,2044-05-03
8201,2084,6117,2015,5,4,xyz,2044-05-04
3148,7195,-4047,2015,5,5,xyz,2044-05-05
7910,9871,-1961,2015,5,6,xyz,2044-05-06
3561,3473,88,2015,5,7,xyz,2044-05-07
6414,5477,937,2015,5,8,xyz,2044-05-08
2994,6468,-3474,2015,5,9,xyz,2044-05-09
6718,8834,-2116,2015,5,10,xyz,2044-05-10
5963,3035,2928,2015,5,11,xyz,2044-05-11
9621,9152,469,2015,5,12,xyz,2044-05-12
8474,1770,6704,2015,5,13,xyz,2044-05-13
8283,6618,1665,2015,5,14,xyz,2044-05-14
6279,3898,2381,2015,5,15,xyz,2044-05-15
9229,1932,7297,2015,5,16,xyz,2044-05-16
7624,2471,5153,2015,5,17,xyz,2044-05-17
2575,9348,-6773,2015,5,18,xyz,2044-05-18
1090,4940,-3850,2015,5,19,xyz,2044-05-19
7995,7229,766,2015,5,20,xyz,2044-05-20
7257,3015,4242,2015,5,21,xyz,2044-05-21
3173,9434,-6261,2015,5,22,xyz,2044-05-22
7625,4550,3075,2015,5,23,xyz,2044-05-23
1904,2351,-447,2015,5,24,xyz,2044-05-24
5453,6269,-816,2015,5,25,xyz,2044-05-25
9493,2742,6751,2015,5,26,xyz,2044-05-26
6349,4439,1910,2015,5,27,xyz,2044-05-27
4042,2153,1889,2015,5,28,xyz,2044-05-28
5130,6832,-1702,2015,5,29,xyz,2044-05-29
9177,8960,217,2015,5,30,xyz,2044-05-30
6460,9107,-2647,2015,5,31,xyz,2044-05-31
3372,4202,-830,2015,6,1,xyz,2044-06-01
2166,8496,-6330,2015,6,2,xyz,2044-06-02
6869,2472,4397,2015,6,3,xyz,2044-06-03
4162,4711,-549,2015,6,4,xyz,2044-06-04
7343,8671,-1328,2015,6,5,xyz,2044-06-05
8719,7321,1398,2015,6,6,xyz,2044-06-06
3925,9537,-5612,2015,6,7,xyz,2044-06-07
8317,5503,2814,2015,6,8,xyz,2044-06-08
8313,3320,4993,2015,6,9,xyz,2044-06-09
8721,2015,6706,2015,6,10,xyz,2044-06-10
1733,2347,-614,2015,6,11,xyz,2044-06-11
3510,5955,-2445,2015,6,12,xyz,2044-06-12
4731,8251,-3520,2015,6,13,xyz,2044-06-13
8732,3809,4923,2015,6,14,xyz,2044-06-14
9060,3881,5179,2015,6,15,xyz,2044-06-15
4196,4575,-379,2015,6,16,xyz,2044-06-16
2764,4822,-2058,2015,6,17,xyz,2044-06-17
5012,8680,-3668,2015,6,18,xyz,2044-06-18
4600,1044,3556,2015,6,19,xyz,2044-06-19
2844,3102,-258,2015,6,20,xyz,2044-06-20
4247,2465,1782,2015,6,21,xyz,2044-06-21
9888,1043,8845,2015,6,22,xyz,2044-06-22
3092,9665,-6573,2015,6,23,xyz,2044-06-23
8775,8545,230,2015,6,24,xyz,2044-06-24
5638,2282,3356,2015,6,25,xyz,2044-06-25
4475,863,3612,2015,6,26,xyz,2044-06-26
6383,2926,3457,2015,6,27,xyz,2044-06-27
1020,9780,-8760,2015,6,28,xyz,2044-06-28
9945,4303,5642,2015,6,29,xyz,2044-06-29
9532,9228,304,2015,6,30,xyz,2044-06-30
3938,3815,123,2015,7,1,xyz,2044-07-01
2868,6720,-3852,2015,7,2,xyz,2044-07-02
5812,7614,-1802,2015,7,3,xyz,2044-07-03
5270,4182,1088,2015,7,4,xyz,2044-07-04
1561,1854,-293,2015,7,5,xyz,2044-07-05
8755,1662,7093,2015,7,6,xyz,2044-07-06
8878,4256,4622,2015,7,7,xyz,2044-07-07
9938,1083,8855,2015,7,8,xyz,2044-07-08
3870,4079,-209,2015,7,9,xyz,2044-07-09
1865,1868,-3,2015,7,10,xyz,2044-07-10
8958,1342,7616,2015,7,11,xyz,2044-07-11
7543,949,6594,2015,7,12,xyz,2044-07-12
1843,6511,-4668,2015,7,13,xyz,2044-07-13
8423,4334,4089,2015,7,14,xyz,2044-07-14
4882,1062,3820,2015,7,15,xyz,2044-07-15
8236,6720,1516,2015,7,16,xyz,2044-07-16
3502,9128,-5626,2015,7,17,xyz,2044-07-17
1375,1598,-223,2015,7,18,xyz,2044-07-18
7065,7979,-914,2015,7,19,xyz,2044-07-19
6053,5488,565,2015,7,20,xyz,2044-07-20
6778,8218,-1440,2015,7,21,xyz,2044-07-21
8350,8129,221,2015,7,22,xyz,2044-07-22
6983,9187,-2204,2015,7,23,xyz,2044-07-23
1194,1003,191,2015,7,24,xyz,2044-07-24
5617,4317,1300,2015,7,25,xyz,2044-07-25
2227,3989,-1762,2015,7,26,xyz,2044-07-26
9881,4585,5296,2015,7,27,xyz,2044-07-27
4713,5757,-1044,2015,7,28,xyz,2044-07-28
9450,8234,1216,2015,7,29,xyz,2044-07-29
5774,3010,2764,2015,7,30,xyz,2044-07-30
7197,2628,4569,2015,7,31,xyz,2044-07-31
1163,7253,-6090,2015,8,1,xyz,2044-08-01
7418,3977,3441,2015,8,2,xyz,2044-08-02
2191,5711,-3520,2015,8,3,xyz,2044-08-03
6411,7913,-1502,2015,8,4,xyz,2044-08-04
9962,1808,8154,2015,8,5,xyz,2044-08-05
3221,5816,-2595,2015,8,6,xyz,2044-08-06
5065,6922,-1857,2015,8,7,xyz,2044-08-07
7896,3882,4014,2015,8,8,xyz,2044-08-08
8359,4216,4143,2015,8,9,xyz,2044-08-09
6218,8602,-2384,2015,8,10,xyz,2044-08-10
6703,1080,5623,2015,8,11,xyz,2044-08-11
2209,1263,946,2015,8,12,xyz,2044-08-12
1400,2242,-842,2015,8,13,xyz,2044-08-13
4679,6083,-1404,2015,8,14,xyz,2044-08-14
8548,9846,-1298,2015,8,15,xyz,2044-08-15
8587,9943,-1356,2015,8,16,xyz,2044-08-16
3509,3568,-59,2015,8,17,xyz,2044-08-17
3544,8417,-4873,2015,8,18,xyz,2044-08-18
3404,3476,-72,2015,8,19,xyz,2044-08-19
4916,3456,1460,2015,8,20,xyz,2044-08-20
2916,7059,-4143,2015,8,21,xyz,2044-08-21
6602,8985,-2383,2015,8,22,xyz,2044-08-22
8167,6190,1977,2015,8,23,xyz,2044-08-23
5182,1932,3250,2015,8,24,xyz,2044-08-24
4151,1315,2836,2015,8,25,xyz,2044-08-25
4912,8816,-3904,2015,8,26,xyz,2044-08-26
2374,8124,-5750,2015,8,27,xyz,2044-08-27
2005,9271,-7266,2015,8,28,xyz,2044-08-28
7516,4966,2550,2015,8,29,xyz,2044-08-29
3553,2362,1191,2015,8,30,xyz,2044-08-30
1360,5523,-4163,2015,8,31,xyz,2044-08-31
8475,2592,5883,2015,9,1,xyz,2044-09-01
8971,2221,6750,2015,9,2,xyz,2044-09-02
9625,8725,900,2015,9,3,xyz,2044-09-03
1242,9163,-7921,2015,9,4,xyz,2044-09-04
1519,9502,-7983,2015,9,5,xyz,2044-09-05
1498,9571,-8073,2015,9,6,xyz,2044-09-06
3372,3323,49,2015,9,7,xyz,2044-09-07
4380,7896,-3516,2015,9,8,xyz,2044-09-08
8203,826,7377,2015,9,9,xyz,2044-09-09
3673,8755,-5082,2015,9,10,xyz,2044-09-10
1460,3692,-2232,2015,9,11,xyz,2044-09-11
7504,7229,275,2015,9,12,xyz,2044-09-12
8981,5677,3304,2015,9,13,xyz,2044-09-13
1459,6490,-5031,2015,9,14,xyz,2044-09-14
1378,8523,-7145,2015,9,15,xyz,2044-09-15
5438,9316,-3878,2015,9,16,xyz,2044-09-16
1849,5387,-3538,2015,9,17,xyz,2044-09-17
2770,7512,-4742,2015,9,18,xyz,2044-09-18
9745,4867,4878,2015,9,19,xyz,2044-09-19
3979,6881,-2902,2015,9,20,xyz,2044-09-20
7216,3864,3352,2015,9,21,xyz,2044-09-21
3847,1274,2573,2015,9,22,xyz,2044-09-22
9764,4082,5682,2015,9,23,xyz,2044-09-23
1382,6884,-5502,2015,9,24,xyz,2044-09-24
9245,6907,2338,2015,9,25,xyz,2044-09-25
3213,6237,-3024,2015,9,26,xyz,2044-09-26
9475,6419,3056,2015,9,27,xyz,2044-09-27
1837,7633,-5796,2015,9,28,xyz,2044-09-28
3956,10000,-6044,2015,9,29,xyz,2044-09-29
1917,7272,-5355,2015,9,30,xyz,2044-09-30
4055,8967,-4912,2015,10,1,xyz,2044-10-01
7701,4074,3627,2015,10,2,xyz,2044-10-02
6026,8896,-2870,2015,10,3,xyz,2044-10-03
4076,6312,-2236,2015,10,4,xyz,2044-10-04
1660,6989,-5329,2015,10,5,xyz,2044-10-05
2099,7242,-5143,2015,10,6,xyz,2044-10-06
4728,819,3909,2015,10,7,xyz,2044-10-07
5608,6557,-949,2015,10,8,xyz,2044-10-08
3561,8200,-4639,2015,10,9,xyz,2044-10-09
1280,6191,-4911,2015,10,10,xyz,2044-10-10
7411,5973,1438,2015,10,11,xyz,2044-10-11
5102,3226,1876,2015,10,12,xyz,2044-10-12
2385,2813,-428,2015,10,13,xyz,2044-10-13
9940,7743,2197,2015,10,14,xyz,2044-10-14
4544,6419,-1875,2015,10,15,xyz,2044-10-15
4952,7450,-2498,2015,10,16,xyz,2044-10-16
1187,1116,71,2015,10,17,xyz,2044-10-17
3515,9918,-6403,2015,10,18,xyz,2044-10-18
7286,2739,4547,2015,10,19,xyz,2044-10-19
1909,5319,-3410,2015,10,20,xyz,2044-10-20
9078,1388,7690,2015,10,21,xyz,2044-10-21
1923,3743,-1820,2015,10,22,xyz,2044-10-22
6517,9618,-3101,2015,10,23,xyz,2044-10-23
6023,7245,-1222,2015,10,24,xyz,2044-10-24
4346,8281,-3935,2015,10,25,xyz,2044-10-25
5070,4734,336,2015,10,26,xyz,2044-10-26
2751,5293,-2542,2015,10,27,xyz,2044-10-27
9788,3874,5914,2015,10,28,xyz,2044-10-28
1582,3829,-2247,2015,10,29,xyz,2044-10-29
9301,8081,1220,2015,10,30,xyz,2044-10-30
1475,2673,-1198,2015,10,31,xyz,2044-10-31
6135,727,5408,2015,11,1,xyz,2044-11-01
3632,3334,298,2015,11,2,xyz,2044-11-02
9662,8503,1159,2015,11,3,xyz,2044-11-03
7517,8517,-1000,2015,11,4,xyz,2044-11-04
3060,7299,-4239,2015,11,5,xyz,2044-11-05
3379,8191,-4812,2015,11,6,xyz,2044-11-06
4270,4566,-296,2015,11,7,xyz,2044-11-07
9741,4214,5527,2015,11,8,xyz,2044-11-08
8730,8319,411,2015,11,9,xyz,2044-11-09
1995,2326,-331,2015,11,10,xyz,2044-11-10
5415,8370,-2955,2015,11,11,xyz,2044-11-11
3262,6199,-2937,2015,11,12,xyz,2044-11-12
8978,9823,-845,2015,11,13,xyz,2044-11-13
4099,5388,-1289,2015,11,14,xyz,2044-11-14
8868,1028,7840,2015,11,15,xyz,2044-11-15
4661,5901,-1240,2015,11,16,xyz,2044-11-16
8670,5665,3005,2015,11,17,xyz,2044-11-17
2329,7824,-5495,2015,11,18,xyz,2044-11-18
3449,5025,-1576,2015,11,19,xyz,2044-11-19
3234,2521,713,2015,11,20,xyz,2044-11-20
1268,829,439,2015,11,21,xyz,2044-11-21
7756,4582,3174,2015,11,22,xyz,2044-11-22
6481,5849,632,2015,11,23,xyz,2044-11-23
6559,7240,-681,2015,11,24,xyz,2044-11-24
3425,3505,-80,2015,11,25,xyz,2044-11-25
6234,7678,-1444,2015,11,26,xyz,2044-11-26
6244,4572,1672,2015,11,27,xyz,2044-11-27
3672,6559,-2887,2015,11,28,xyz,2044-11-28
5378,4124,1254,2015,11,29,xyz,2044-11-29
5843,2510,3333,2015,11,30,xyz,2044-11-30
2112,1791,321,2015,12,1,xyz,2044-12-01
9148,6290,2858,2015,12,2,xyz,2044-12-02
6162,2713,3449,2015,12,3,xyz,2044-12-03
9666,4090,5576,2015,12,4,xyz,2044-12-04
7629,5387,2242,2015,12,5,xyz,2044-12-05
7873,3950,3923,2015,12,6,xyz,2044-12-06
4924,5520,-596,2015,12,7,xyz,2044-12-07
2966,5983,-3017,2015,12,8,xyz,2044-12-08
5217,2236,2981,2015,12,9,xyz,2044-12-09
5771,3131,2640,2015,12,10,xyz,2044-12-10
1114,1582,-468,2015,12,11,xyz,2044-12-11
6509,3177,3332,2015,12,12,xyz,2044-12-12
7399,4807,2592,2015,12,13,xyz,2044-12-13
2719,4450,-1731,2015,12,14,xyz,2044-12-14
8067,2690,5377,2015,12,15,xyz,2044-12-15
8979,7965,1014,2015,12,16,xyz,2044-12-16
9536,3835,5701,2015,12,17,xyz,2044-12-17
4002,4521,-519,2015,12,18,xyz,2044-12-18
3558,1444,2114,2015,12,19,xyz,2044-12-19
1259,608,651,2015,12,20,xyz,2044-12-20
1882,9111,-7229,2015,12,21,xyz,2044-12-21
7022,1129,5893,2015,12,22,xyz,2044-12-22
6635,4490,2145,2015,12,23,xyz,2044-12-23
3560,9097,-5537,2015,12,24,xyz,2044-12-24
9329,4455,4874,2015,12,25,xyz,2044-12-25
5483,6658,-1175,2015,12,26,xyz,2044-12-26
4628,2470,2158,2015,12,27,xyz,2044-12-27
7211,3300,3911,2015,12,28,xyz,2044-12-28
3926,9043,-5117,2015,12,29,xyz,2044-12-29
4582,7337,-2755,2015,12,30,xyz,2044-12-30
8237,7111,1126,2015,12,31,xyz,2044-12-31
5608,2079,3529,2016,1,1,xyz,2045-01-01
8623,9760,-1137,2016,1,2,xyz,2045-01-02
4592,6866,-2274,2016,1,3,xyz,2045-01-03
2955,9311,-6356,2016,1,4,xyz,2045-01-04
3197,910,2287,2016,1,5,xyz,2045-01-05
3288,8726,-5438,2016,1,6,xyz,2045-01-06
8522,9823,-1301,2016,1,7,xyz,2045-01-07
7696,9312,-1616,2016,1,8,xyz,2045-01-08
1704,7219,-5515,2016,1,9,xyz,2045-01-09
9087,7456,1631,2016,1,10,xyz,2045-01-10
2155,2747,-592,2016,1,11,xyz,2045-01-11
2776,6639,-3863,2016,1,12,xyz,2045-01-12
4740,939,3801,2016,1,13,xyz,2045-01-13
5197,6657,-1460,2016,1,14,xyz,2045-01-14
4679,2559,2120,2016,1,15,xyz,2045-01-15
1034,8267,-7233,2016,1,16,xyz,2045-01-16
7173,3168,4005,2016,1,17,xyz,2045-01-17
3049,5754,-2705,2016,1,18,xyz,2045-01-18
6773,9623,-2850,2016,1,19,xyz,2045-01-19
2459,4429,-1970,2016,1,20,xyz,2045-01-20
4876,5108,-232,2016,1,21,xyz,2045-01-21
7540,7395,145,2016,1,22,xyz,2045-01-22
4983,2435,2548,2016,1,23,xyz,2045-01-23
8903,8804,99,2016,1,24,xyz,2045-01-24
5991,8656,-2665,2016,1,25,xyz,2045-01-25
6866,6913,-47,2016,1,26,xyz,2045-01-26
5200,4911,289,2016,1,27,xyz,2045-01-27
7623,1120,6503,2016,1,28,xyz,2045-01-28
5671,2089,3582,2016,1,29,xyz,2045-01-29
5296,9423,-4127,2016,1,30,xyz,2045-01-30
2377,5878,-3501,2016,1,31,xyz,2045-01-31
9912,9894,18,2016,2,1,xyz,2045-02-01
4107,5535,-1428,2016,2,2,xyz,2045-02-02
4535,5209,-674,2016,2,3,xyz,2045-02-03
5837,9076,-3239,2016,2,4,xyz,2045-02-04
1884,2205,-321,2016,2,5,xyz,2045-02-05
1582,5701,-4119,2016,2,6,xyz,2045-02-06
7371,8371,-1000,2016,2,7,xyz,2045-02-07
6843,7120,-277,2016,2,8,xyz,2045-02-08
7568,2660,4908,2016,2,9,xyz,2045-02-09
5884,1093,4791,2016,2,10,xyz,2045-02-10
5621,4674,947,2016,2,11,xyz,2045-02-11
8392,1248,7144,2016,2,12,xyz,2045-02-12
1821,3573,-1752,2016,2,13,xyz,2045-02-13
6476,6716,-240,2016,2,14,xyz,2045-02-14
3971,1666,2305,2016,2,15,xyz,2045-02-15
8271,6375,1896,2016,2,16,xyz,2045-02-16
4306,969,3337,2016,2,17,xyz,2045-02-17
8159,3060,5099,2016,2,18,xyz,2045-02-18
2546,5768,-3222,2016,2,19,xyz,2045-02-19
4666,613,4053,2016,2,20,xyz,2045-02-20
1698,8691,-6993,2016,2,21,xyz,2045-02-21
5073,4865,208,2016,2,22,xyz,2045-02-22
2082,6101,-4019,2016,2,23,xyz,2045-02-23
5155,6400,-1245,2016,2,24,xyz,2045-02-24
8386,6167,2219,2016,2,25,xyz,2045-02-25
3060,7421,-4361,2016,2,26,xyz,2045-02-26
5665,5074,591,2016,2,27,xyz,2045-02-27
7449,3889,3560,2016,2,28,xyz,2045-02-28
4991,946,4045,2016,3,1,xyz,2045-03-01
5022,1207,3815,2016,3,2,xyz,2045-03-02
9530,1899,7631,2016,3,3,xyz,2045-03-03
2441,4879,-2438,2016,3,4,xyz,2045-03-04
7184,5892,1292,2016,3,5,xyz,2045-03-05
5761,5257,504,2016,3,6,xyz,2045-03-06
8636,8248,388,2016,3,7,xyz,2045-03-07
2157,6119,-3962,2016,3,8,xyz,2045-03-08
2832,3735,-903,2016,3,9,xyz,2045-03-09
1410,5346,-3936,2016,3,10,xyz,2045-03-10
1252,9074,-7822,2016,3,11,xyz,2045-03-11
2616,6782,-4166,2016,3,12,xyz,2045-03-12
3005,5748,-2743,2016,3,13,xyz,2045-03-13
5151,2169,2982,2016,3,14,xyz,2045-03-14
8501,5076,3425,2016,3,15,xyz,2045-03-15
3256,9231,-5975,2016,3,16,xyz,2045-03-16
4499,6328,-1829,2016,3,17,xyz,2045-03-17
9833,7534,2299,2016,3,18,xyz,2045-03-18
8743,5061,3682,2016,3,19,xyz,2045-03-19
2747,7866,-5119,2016,3,20,xyz,2045-03-20
8836,8834,2,2016,3,21,xyz,2045-03-21
8000,6255,1745,2016,3,22,xyz,2045-03-22
2359,4044,-1685,2016,3,23,xyz,2045-03-23
5176,5479,-303,2016,3,24,xyz,2045-03-24
8179,3167,5012,2016,3,25,xyz,2045-03-25
1536,4258,-2722,2016,3,26,xyz,2045-03-26
8916,4470,4446,2016,3,27,xyz,2045-03-27
8146,4826,3320,2016,3,28,xyz,2045-03-28
7341,1854,5487,2016,3,29,xyz,2045-03-29
8793,7156,1637,2016,3,30,xyz,2045-03-30
7727,5531,2196,2016,3,31,xyz,2045-03-31
4013,4109,-96,2016,4,1,xyz,2045-04-01
1524,3163,-1639,2016,4,2,xyz,2045-04-02
4658,9404,-4746,2016,4,3,xyz,2045-04-03
4137,2743,1394,2016,4,4,xyz,2045-04-04
7807,9587,-1780,2016,4,5,xyz,2045-04-05
1543,4322,-2779,2016,4,6,xyz,2045-04-06
9581,8318,1263,2016,4,7,xyz,2045-04-07
6340,7594,-1254,2016,4,8,xyz,2045-04-08
7915,7892,23,2016,4,9,xyz,2045-04-09
1385,7347,-5962,2016,4,10,xyz,2045-04-10
6613,6373,240,2016,4,11,xyz,2045-04-11
9839,6645,3194,2016,4,12,xyz,2045-04-12
5531,9659,-4128,2016,4,13,xyz,2045-04-13
5614,2529,3085,2016,4,14,xyz,2045-04-14
9843,8136,1707,2016,4,15,xyz,2045-04-15
3367,8555,-5188,2016,4,16,xyz,2045-04-16
1889,7630,-5741,2016,4,17,xyz,2045-04-17
9144,6446,2698,2016,4,18,xyz,2045-04-18
1575,1661,-86,2016,4,19,xyz,2045-04-19
1539,3267,-1728,2016,4,20,xyz,2045-04-20
8406,6696,1710,2016,4,21,xyz,2045-04-21
5464,3197,2267,2016,4,22,xyz,2045-04-22
8862,8863,-1,2016,4,23,xyz,2045-04-23
4925,535,4390,2016,4,24,xyz,2045-04-24
1750,4443,-2693,2016,4,25,xyz,2045-04-25
6922,4175,2747,2016,4,26,xyz,2045-04-26
7854,824,7030,2016,4,27,xyz,2045-04-27
7178,5447,1731,2016,4,28,xyz,2045-04-28
7366,6744,622,2016,4,29,xyz,2045-04-29
2813,6973,-4160,2016,4,30,xyz,2045-04-30
7501,6110,1391,2016,5,1,xyz,2045-05-01
8044,4735,3309,2016,5,2,xyz,2045-05-02
3185,587,2598,2016,5,3,xyz,2045-05-03
7993,4647,3346,2016,5,4,xyz,2045-05-04
4669,1113,3556,2016,5,5,xyz,2045-05-05
2030,5701,-3671,2016,5,6,xyz,2045-05-06
6993,8255,-1262,2016,5,7,xyz,2045-05-07
8235,8676,-441,2016,5,8,xyz,2045-05-08
9480,4535,4945,2016,5,9,xyz,2045-05-09
8717,5279,3438,2016,5,10,xyz,2045-05-10
8572,3132,5440,2016,5,11,xyz,2045-05-11
1545,4517,-2972,2016,5,12,xyz,2045-05-12
8098,7953,145,2016,5,13,xyz,2045-05-13
3000,1664,1336,2016,5,14,xyz,2045-05-14
4478,2176,2302,2016,5,15,xyz,2045-05-15
6140,7149,-1009,2016,5,16,xyz,2045-05-16
7837,8224,-387,2016,5,17,xyz,2045-05-17
9816,3995,5821,2016,5,18,xyz,2045-05-18
1754,5591,-3837,2016,5,19,xyz,2045-05-19
1603,6535,-4932,2016,5,20,xyz,2045-05-20
9612,9766,-154,2016,5,21,xyz,2045-05-21
7270,5324,1946,2016,5,22,xyz,2045-05-22
4217,1304,2913,2016,5,23,xyz,2045-05-23
2119,4852,-2733,2016,5,24,xyz,2045-05-24
8568,7328,1240,2016,5,25,xyz,2045-05-25
8762,5999,2763,2016,5,26,xyz,2045-05-26
8160,7745,415,2016,5,27,xyz,2045-05-27
3020,3980,-960,2016,5,28,xyz,2045-05-28
1046,4444,-3398,2016,5,29,xyz,2045-05-29
6111,6880,-769,2016,5,30,xyz,2045-05-30
7623,9576,-1953,2016,5,31,xyz,2045-05-31
4107,2234,1873,2016,6,1,xyz,2045-06-01
7964,4152,3812,2016,6,2,xyz,2045-06-02
5761,6507,-746,2016,6,3,xyz,2045-06-03
1908,4207,-2299,2016,6,4,xyz,2045-06-04
8287,9734,-1447,2016,6,5,xyz,2045-06-05
5071,9685,-4614,2016,6,6,xyz,2045-06-06
2981,5081,-2100,2016,6,7,xyz,2045-06-07
1558,6687,-5129,2016,6,8,xyz,2045-06-08
3777,4389,-612,2016,6,9,xyz,2045-06-09
4102,5918,-1816,2016,6,10,xyz,2045-06-10
3737,3983,-246,2016,6,11,xyz,2045-06-11
7930,7855,75,2016,6,12,xyz,2045-06-12
2438,8234,-5796,2016,6,13,xyz,2045-06-13
8268,949,7319,2016,6,14,xyz,2045-06-14
5640,7621,-1981,2016,6,15,xyz,2045-06-15
5262,5328,-66,2016,6,16,xyz,2045-06-16
8397,6909,1488,2016,6,17,xyz,2045-06-17
2501,3315,-814,2016,6,18,xyz,2045-06-18
8937,1802,7135,2016,6,19,xyz,2045-06-19
5532,8049,-2517,2016,6,20,xyz,2045-06-20
5370,7489,-2119,2016,6,21,xyz,2045-06-21
9803,7956,1847,2016,6,22,xyz,2045-06-22
6490,8808,-2318,2016,6,23,xyz,2045-06-23
3235,4541,-1306,2016,6,24,xyz,2045-06-24
3023,4518,-1495,2016,6,25,xyz,2045-06-25
9169,4309,4860,2016,6,26,xyz,2045-06-26
7210,2893,4317,2016,6,27,xyz,2045-06-27
3347,6987,-3640,2016,6,28,xyz,2045-06-28
1819,3882,-2063,2016,6,29,xyz,2045-06-29
3523,7715,-4192,2016,6,30,xyz,2045-06-30
6805,5970,835,2016,7,1,xyz,2045-07-01
7804,7335,469,2016,7,2,xyz,2045-07-02
1824,1617,207,2016,7,3,xyz,2045-07-03
5702,2972,2730,2016,7,4,xyz,2045-07-04
3662,4720,-1058,2016,7,5,xyz,2045-07-05
4977,3071,1906,2016,7,6,xyz,2045-07-06
2121,3066,-945,2016,7,7,xyz,2045-07-07
1998,6892,-4894,2016,7,8,xyz,2045-07-08
5551,7745,-2194,2016,7,9,xyz,2045-07-09
2692,9481,-6789,2016,7,10,xyz,2045-07-10
2385,8903,-6518,2016,7,11,xyz,2045-07-11
7240,5733,1507,2016,7,12,xyz,2045-07-12
5161,4371,790,2016,7,13,xyz,2045-07-13
5192,7371,-2179,2016,7,14,xyz,2045-07-14
3643,3655,-12,2016,7,15,xyz,2045-07-15
3299,4910,-1611,2016,7,16,xyz,2045-07-16
4188,8963,-4775,2016,7,17,xyz,2045-07-17
1678,6628,-4950,2016,7,18,xyz,2045-07-18
6978,9723,-2745,2016,7,19,xyz,2045-07-19
6177,5639,538,2016,7,20,xyz,2045-07-20
8867,4750,4117,2016,7,21,xyz,2045-07-21
5765,7890,-2125,2016,7,22,xyz,2045-07-22
3144,4261,-1117,2016,7,23,xyz,2045-07-23
5870,5321,549,2016,7,24,xyz,2045-07-24
7922,4765,3157,2016,7,25,xyz,2045-07-25
8114,4290,3824,2016,7,26,xyz,2045-07-26
6332,3167,3165,2016,7,27,xyz,2045-07-27
2524,1235,1289,2016,7,28,xyz,2045-07-28
8412,3337,5075,2016,7,29,xyz,2045-07-29
1270,7224,-5954,2016,7,30,xyz,2045-07-30
3607,5198,-1591,2016,7,31,xyz,2045-07-31
8523,9791,-1268,2016,8,1,xyz,2045-08-01
9289,8348,941,2016,8,2,xyz,2045-08-02
1996,2076,-80,2016,8,3,xyz,2045-08-03
9246,9591,-345,2016,8,4,xyz,2045-08-04
8678,4648,4030,2016,8,5,xyz,2045-08-05
6969,1287,5682,2016,8,6,xyz,2045-08-06
3801,3096,705,2016,8,7,xyz,2045-08-07
2254,6159,-3905,2016,8,8,xyz,2045-08-08
9090,3588,5502,2016,8,9,xyz,2045-08-09
7858,8117,-259,2016,8,10,xyz,2045-08-10
2910,3124,-214,2016,8,11,xyz,2045-08-11
1979,3580,-1601,2016,8,12,xyz,2045-08-12
1852,8276,-6424,2016,8,13,xyz,2045-08-13
3453,5797,-2344,2016,8,14,xyz,2045-08-14
5981,5546,435,2016,8,15,xyz,2045-08-15
6230,6775,-545,2016,8,16,xyz,2045-08-16
4581,792,3789,2016,8,17,xyz,2045-08-17
4785,8874,-4089,2016,8,18,xyz,2045-08-18
3460,4605,-1145,2016,8,19,xyz,2045-08-19
7054,2604,4450,2016,8,20,xyz,2045-08-20
1133,9021,-7888,2016,8,21,xyz,2045-08-21
5721,7637,-1916,2016,8,22,xyz,2045-08-22
6237,7111,-874,2016,8,23,xyz,2045-08-23
6194,5666,528,2016,8,24,xyz,2045-08-24
6861,3647,3214,2016,8,25,xyz,2045-08-25
2445,6848,-4403,2016,8,26,xyz,2045-08-26
8720,852,7868,2016,8,27,xyz,2045-08-27
5529,4574,955,2016,8,28,xyz,2045-08-28
6233,8506,-2273,2016,8,29,xyz,2045-08-29
4112,7351,-3239,2016,8,30,xyz,2045-08-30
2436,7629,-5193,2016,8,31,xyz,2045-08-31
1169,8737,-7568,2016,9,1,xyz,2045-09-01
9316,7248,2068,2016,9,2,xyz,2045-09-02
9088,3180,5908,2016,9,3,xyz,2045-09-03
8391,9325,-934,2016,9,4,xyz,2045-09-04
2815,9903,-7088,2016,9,5,xyz,2045-09-05
8742,820,7922,2016,9,6,xyz,2045-09-06
6671,9005,-2334,2016,9,7,xyz,2045-09-07
2069,2967,-898,2016,9,8,xyz,2045-09-08
8817,3921,4896,2016,9,9,xyz,2045-09-09
4485,8359,-3874,2016,9,10,xyz,2045-09-10
5484,2970,2514,2016,9,11,xyz,2045-09-11
6038,1240,4798,2016,9,12,xyz,2045-09-12
5099,2383,2716,2016,9,13,xyz,2045-09-13
3362,9050,-5688,2016,9,14,xyz,2045-09-14
5914,1197,4717,2016,9,15,xyz,2045-09-15
3542,1425,2117,2016,9,16,xyz,2045-09-16
4988,5106,-118,2016,9,17,xyz,2045-09-17
7984,6513,1471,2016,9,18,xyz,2045-09-18
3767,9517,-5750,2016,9,19,xyz,2045-09-19
2498,8150,-5652,2016,9,20,xyz,2045-09-20
3922,6913,-2991,2016,9,21,xyz,2045-09-21
6550,4878,1672,2016,9,22,xyz,2045-09-22
6144,6028,116,2016,9,23,xyz,2045-09-23
4219,2849,1370,2016,9,24,xyz,2045-09-24
6310,1698,4612,2016,9,25,xyz,2045-09-25
6975,5956,1019,2016,9,26,xyz,2045-09-26
2204,5363,-3159,2016,9,27,xyz,2045-09-27
6962,603,6359,2016,9,28,xyz,2045-09-28
2009,4558,-2549,2016,9,29,xyz,2045-09-29
6323,1123,5200,2016,9,30,xyz,2045-09-30
1325,4272,-2947,2016,10,1,xyz,2045-10-01
7842,2742,5100,2016,10,2,xyz,2045-10-02
1332,6744,-5412,2016,10,3,xyz,2045-10-03
1703,3137,-1434,2016,10,4,xyz,2045-10-04
2231,1829,402,2016,10,5,xyz,2045-10-05
9858,8606,1252,2016,10,6,xyz,2045-10-06
5432,6327,-895,2016,10,7,xyz,2045-10-07
5570,7270,-1700,2016,10,8,xyz,2045-10-08
7801,5827,1974,2016,10,9,xyz,2045-10-09
5540,8312,-2772,2016,10,10,xyz,2045-10-10
1003,1155,-152,2016,10,11,xyz,2045-10-11
1741,2741,-1000,2016,10,12,xyz,2045-10-12
6517,9133,-2616,2016,10,13,xyz,2045-10-13
2708,6543,-3835,2016,10,14,xyz,2045-10-14
9474,4238,5236,2016,10,15,xyz,2045-10-15
3619,9429,-5810,2016,10,16,xyz,2045-10-16
3835,6539,-2704,2016,10,17,xyz,2045-10-17
5003,6920,-1917,2016,10,18,xyz,2045-10-18
2426,5450,-3024,2016,10,19,xyz,2045-10-19
5644,1818,3826,2016,10,20,xyz,2045-10-20
9505,1312,8193,2016,10,21,xyz,2045-10-21
1201,9744,-8543,2016,10,22,xyz,2045-10-22
8223,1959,6264,2016,10,23,xyz,2045-10-23
1977,4073,-2096,2016,10,24,xyz,2045-10-24
8971,5735,3236,2016,10,25,xyz,2045-10-25
2800,7924,-5124,2016,10,26,xyz,2045-10-26
5573,5188,385,2016,10,27,xyz,2045-10-27
3070,7279,-4209,2016,10,28,xyz,2045-10-28
4128,8442,-4314,2016,10,29,xyz,2045-10-29
3073,6966,-3893,2016,10,30,xyz,2045-10-30
8838,1344,7494,2016,10,31,xyz,2045-10-31
1314,8894,-7580,2016,11,1,xyz,2045-11-01
4763,1875,2888,2016,11,2,xyz,2045-11-02
1289,3525,-2236,2016,11,3,xyz,2045-11-03
4128,643,3485,2016,11,4,xyz,2045-11-04
4888,1149,3739,2016,11,5,xyz,2045-11-05
5136,6214,-1078,2016,11,6,xyz,2045-11-06
8182,9022,-840,2016,11,7,xyz,2045-11-07
4240,2567,1673,2016,11,8,xyz,2045-11-08
7256,7891,-635,2016,11,9,xyz,2045-11-09
2520,4347,-1827,2016,11,10,xyz,2045-11-10
7580,4578,3002,2016,11,11,xyz,2045-11-11
8221,5344,2877,2016,11,12,xyz,2045-11-12
1896,7295,-5399,2016,11,13,xyz,2045-11-13
7504,5224,2280,2016,11,14,xyz,2045-11-14
5409,1419,3990,2016,11,15,xyz,2045-11-15
5125,4663,462,2016,11,16,xyz,2045-11-16
9902,4689,5213,2016,11,17,xyz,2045-11-17
2636,8873,-6237,2016,11,18,xyz,2045-11-18
1914,602,1312,2016,11,19,xyz,2045-11-19
6973,5360,1613,2016,11,20,xyz,2045-11-20
4231,9633,-5402,2016,11,21,xyz,2045-11-21
6921,9622,-2701,2016,11,22,xyz,2045-11-22
3905,3286,619,2016,11,23,xyz,2045-11-23
1333,2037,-704,2016,11,24,xyz,2045-11-24
8001,9476,-1475,2016,11,25,xyz,2045-11-25
9078,4606,4472,2016,11,26,xyz,2045-11-26
2738,4920,-2182,2016,11,27,xyz,2045-11-27
7478,1633,5845,2016,11,28,xyz,2045-11-28
1766,8709,-6943,2016,11,29,xyz,2045-11-29
6500,5264,1236,2016,11,30,xyz,2045-11-30
8299,5403,2896,2016,12,1,xyz,2045-12-01
7032,822,6210,2016,12,2,xyz,2045-12-02
9063,5188,3875,2016,12,3,xyz,2045-12-03
5468,4409,1059,2016,12,4,xyz,2045-12-04
9346,5444,3902,2016,12,5,xyz,2045-12-05
3418,9894,-6476,2016,12,6,xyz,2045-12-06
1992,1100,892,2016,12,7,xyz,2045-12-07
5161,6624,-1463,2016,12,8,xyz,2045-12-08
7485,5924,1561,2016,12,9,xyz,2045-12-09
3936,9627,-5691,2016,12,10,xyz,2045-12-10
4687,621,4066,2016,12,11,xyz,2045-12-11
3879,8014,-4135,2016,12,12,xyz,2045-12-12
4853,7205,-2352,2016,12,13,xyz,2045-12-13
2249,2482,-233,2016,12,14,xyz,2045-12-14
8794,3576,5218,2016,12,15,xyz,2045-12-15
4442,1781,2661,2016,12,16,xyz,2045-12-16
3638,7552,-3914,2016,12,17,xyz,2045-12-17
6326,6946,-620,2016,12,18,xyz,2045-12-18
5356,2859,2497,2016,12,19,xyz,2045-12-19
7145,5404,1741,2016,12,20,xyz,2045-12-20
1615,7261,-5646,2016,12,21,xyz,2045-12-21
9324,4606,4718,2016,12,22,xyz,2045-12-22
6368,4020,2348,2016,12,23,xyz,2045-12-23
2876,3056,-180,2016,12,24,xyz,2045-12-24
6034,7235,-1201,2016,12,25,xyz,2045-12-25
9081,8921,160,2016,12,26,xyz,2045-12-26
8518,2863,5655,2016,12,27,xyz,2045-12-27
8630,5738,2892,2016,12,28,xyz,2045-12-28
4925,4790,135,2016,12,29,xyz,2045-12-29
7696,1305,6391,2016,12,30,xyz,2045-12-30
7581,6353,1228,2016,12,31,xyz,2045-12-31
2461,5220,-2759,2017,1,1,xyz,2046-01-01
5176,9955,-4779,2017,1,2,xyz,2046-01-02
6008,5316,692,2017,1,3,xyz,2046-01-03
7797,8302,-505,2017,1,4,xyz,2046-01-04
1198,1618,-420,2017,1,5,xyz,2046-01-05
7507,5238,2269,2017,1,6,xyz,2046-01-06
2509,4064,-1555,2017,1,7,xyz,2046-01-07
4717,1581,3136,2017,1,8,xyz,2046-01-08
6044,598,5446,2017,1,9,xyz,2046-01-09
1636,9271,-7635,2017,1,10,xyz,2046-01-10
9970,3825,6145,2017,1,11,xyz,2046-01-11
2091,3485,-1394,2017,1,12,xyz,2046-01-12
8869,7018,1851,2017,1,13,xyz,2046-01-13
6552,8739,-2187,2017,1,14,xyz,2046-01-14
1984,601,1383,2017,1,15,xyz,2046-01-15
7061,8767,-1706,2017,1,16,xyz,2046-01-16
2324,8319,-5995,2017,1,17,xyz,2046-01-17
2695,3560,-865,2017,1,18,xyz,2046-01-18
8551,7267,1284,2017,1,19,xyz,2046-01-19
4520,4469,51,2017,1,20,xyz,2046-01-20
5181,9817,-4636,2017,1,21,xyz,2046-01-21
3885,3846,39,2017,1,22,xyz,2046-01-22
3504,1230,2274,2017,1,23,xyz,2046-01-23
8860,9457,-597,2017,1,24,xyz,2046-01-24
4154,872,3282,2017,1,25,xyz,2046-01-25
8627,2814,5813,2017,1,26,xyz,2046-01-26
7622,5353,2269,2017,1,27,xyz,2046-01-27
1720,8679,-6959,2017,1,28,xyz,2046-01-28
4476,1007,3469,2017,1,29,xyz,2046-01-29
8057,6627,1430,2017,1,30,xyz,2046-01-30
6840,6992,-152,2017,1,31,xyz,2046-01-31
1858,7848,-5990,2017,2,1,xyz,2046-02-01
6110,6218,-108,2017,2,2,xyz,2046-02-02
5333,4463,870,2017,2,3,xyz,2046-02-03
6870,5525,1345,2017,2,4,xyz,2046-02-04
8773,1802,6971,2017,2,5,xyz,2046-02-05
4048,5467,-1419,2017,2,6,xyz,2046-02-06
8718,6599,2119,2017,2,7,xyz,2046-02-07
5620,8691,-3071,2017,2,8,xyz,2046-02-08
5773,7273,-1500,2017,2,9,xyz,2046-02-09
8515,8831,-316,2017,2,10,xyz,2046-02-10
6581,6525,56,2017,2,11,xyz,2046-02-11
9822,8669,1153,2017,2,12,xyz,2046-02-12
4413,3470,943,2017,2,13,xyz,2046-02-13
5894,9478,-3584,2017,2,14,xyz,2046-02-14
2068,5338,-3270,2017,2,15,xyz,2046-02-15
5001,8522,-3521,2017,2,16,xyz,2046-02-16
3962,2202,1760,2017,2,17,xyz,2046-02-17
3081,7874,-4793,2017,2,18,xyz,2046-02-18
5172,1388,3784,2017,2,19,xyz,2046-02-19
7490,9440,-1950,2017,2,20,xyz,2046-02-20
5867,8817,-2950,2017,2,21,xyz,2046-02-21
7520,4829,2691,2017,2,22,xyz,2046-02-22
4451,531,3920,2017,2,23,xyz,2046-02-23
9702,4245,5457,2017,2,24,xyz,2046-02-24
4364,9986,-5622,2017,2,25,xyz,2046-02-25
4446,6795,-2349,2017,2,26,xyz,2046-02-26
2626,5203,-2577,2017,2,27,xyz,2046-02-27
9430,4391,5039,2017,2,28,xyz,2046-02-28
6687,3625,3062,2017,3,1,xyz,2046-03-01
2811,2900,-89,2017,3,2,xyz,2046-03-02
6549,4883,1666,2017,3,3,xyz,2046-03-03
5856,1599,4257,2017,3,4,xyz,2046-03-04
4273,2050,2223,2017,3,5,xyz,2046-03-05
9328,1717,7611,2017,3,6,xyz,2046-03-06
8724,9227,-503,2017,3,7,xyz,2046-03-07
7130,8230,-1100,2017,3,8,xyz,2046-03-08
5630,5011,619,2017,3,9,xyz,2046-03-09
4712,9969,-5257,2017,3,10,xyz,2046-03-10
9560,2800,6760,2017,3,11,xyz,2046-03-11
5640,7713,-2073,2017,3,12,xyz,2046-03-12
8963,3389,5574,2017,3,13,xyz,2046-03-13
6143,5047,1096,2017,3,14,xyz,2046-03-14
6214,1945,4269,2017,3,15,xyz,2046-03-15
1022,711,311,2017,3,16,xyz,2046-03-16
6465,8843,-2378,2017,3,17,xyz,2046-03-17
8809,7939,870,2017,3,18,xyz,2046-03-18
2165,5358,-3193,2017,3,19,xyz,2046-03-19
3699,575,3124,2017,3,20,xyz,2046-03-20
7713,5197,2516,2017,3,21,xyz,2046-03-21
8843,792,8051,2017,3,22,xyz,2046-03-22
9916,8239,1677,2017,3,23,xyz,2046-03-23
4881,9623,-4742,2017,3,24,xyz,2046-03-24
3951,2686,1265,2017,3,25,xyz,2046-03-25
1467,4969,-3502,2017,3,26,xyz,2046-03-26
3589,7660,-4071,2017,3,27,xyz,2046-03-27
8822,2543,6279,2017,3,28,xyz,2046-03-28
5166,1504,3662,2017,3,29,xyz,2046-03-29
9220,2439,6781,2017,3,30,xyz,2046-03-30
9665,2812,6853,2017,3,31,xyz,2046-03-31
9827,6239,3588,2017,4,1,xyz,2046-04-01
5983,2813,3170,2017,4,2,xyz,2046-04-02
3568,5937,-2369,2017,4,3,xyz,2046-04-03
6934,2426,4508,2017,4,4,xyz,2046-04-04
7037,6510,527,2017,4,5,xyz,2046-04-05
2919,9670,-6751,2017,4,6,xyz,2046-04-06
8913,4132,4781,2017,4,7,xyz,2046-04-07
6049,4083,1966,2017,4,8,xyz,2046-04-08
8189,9033,-844,2017,4,9,xyz,2046-04-09
4996,5558,-562,2017,4,10,xyz,2046-04-10
2752,4288,-1536,2017,4,11,xyz,2046-04-11
9827,3185,6642,2017,4,12,xyz,2046-04-12
5604,4893,711,2017,4,13,xyz,2046-04-13
9268,2953,6315,2017,4,14,xyz,2046-04-14
7637,8861,-1224,2017,4,15,xyz,2046-04-15
3197,5451,-2254,2017,4,16,xyz,2046-04-16
4269,7755,-3486,2017,4,17,xyz,2046-04-17
4479,8288,-3809,2017,4,18,xyz,2046-04-18
4438,5095,-657,2017,4,19,xyz,2046-04-19
6633,7712,-1079,2017,4,20,xyz,2046-04-20
2038,4901,-2863,2017,4,21,xyz,2046-04-21
7889,7381,508,2017,4,22,xyz,2046-04-22
7248,4293,2955,2017,4,23,xyz,2046-04-23
1464,5947,-4483,2017,4,24,xyz,2046-04-24
8398,5763,2635,2017,4,25,xyz,2046-04-25
8369,7977,392,2017,4,26,xyz,2046-04-26
8781,6531,2250,2017,4,27,xyz,2046-04-27
5614,1858,3756,2017,4,28,xyz,2046-04-28
7600,1641,5959,2017,4,29,xyz,2046-04-29
2671,1034,1637,2017,4,30,xyz,2046-04-30
8702,9515,-813,2017,5,1,xyz,2046-05-01
7591,8236,-645,2017,5,2,xyz,2046-05-02
2819,1387,1432,2017,5,3,xyz,2046-05-03
1590,4169,-2579,2017,5,4,xyz,2046-05-04
9738,9970,-232,2017,5,5,xyz,2046-05-05
3062,9546,-6484,2017,5,6,xyz,2046-05-06
4933,3055,1878,2017,5,7,xyz,2046-05-07
3286,1871,1415,2017,5,8,xyz,2046-05-08
5129,7494,-2365,2017,5,9,xyz,2046-05-09
7483,9925,-2442,2017,5,10,xyz,2046-05-10
5275,1567,3708,2017,5,11,xyz,2046-05-11
6652,8974,-2322,2017,5,12,xyz,2046-05-12
9078,2411,6667,2017,5,13,xyz,2046-05-13
7566,8881,-1315,2017,5,14,xyz,2046-05-14
4598,8918,-4320,2017,5,15,xyz,2046-05-15
8971,9678,-707,2017,5,16,xyz,2046-05-16
9649,4397,5252,2017,5,17,xyz,2046-05-17
2773,2520,253,2017,5,18,xyz,2046-05-18
1522,9159,-7637,2017,5,19,xyz,2046-05-19
5814,6284,-470,2017,5,20,xyz,2046-05-20
9209,9393,-184,2017,5,21,xyz,2046-05-21
5547,1293,4254,2017,5,22,xyz,2046-05-22
9430,4869,4561,2017,5,23,xyz,2046-05-23
3679,7892,-4213,2017,5,24,xyz,2046-05-24
5209,6639,-1430,2017,5,25,xyz,2046-05-25
6959,8635,-1676,2017,5,26,xyz,2046-05-26
6132,4710,1422,2017,5,27,xyz,2046-05-27
4557,8852,-4295,2017,5,28,xyz,2046-05-28
6666,5601,1065,2017,5,29,xyz,2046-05-29
3966,7282,-3316,2017,5,30,xyz,2046-05-30
3223,2274,949,2017,5,31,xyz,2046-05-31
3673,3885,-212,2017,6,1,xyz,2046-06-01
5256,6028,-772,2017,6,2,xyz,2046-06-02
8138,2098,6040,2017,6,3,xyz,2046-06-03
4179,6926,-2747,2017,6,4,xyz,2046-06-04
2235,9074,-6839,2017,6,5,xyz,2046-06-05
9330,3013,6317,2017,6,6,xyz,2046-06-06
4956,8301,-3345,2017,6,7,xyz,2046-06-07
9419,5719,3700,2017,6,8,xyz,2046-06-08
4384,6589,-2205,2017,6,9,xyz,2046-06-09
8157,8468,-311,2017,6,10,xyz,2046-06-10
4192,3996,196,2017,6,11,xyz,2046-06-11
7781,8662,-881,2017,6,12,xyz,2046-06-12
9544,7969,1575,2017,6,13,xyz,2046-06-13
6427,5555,872,2017,6,14,xyz,2046-06-14
5153,4998,155,2017,6,15,xyz,2046-06-15
7011,7465,-454,2017,6,16,xyz,2046-06-16
3679,7769,-4090,2017,6,17,xyz,2046-06-17
1249,2984,-1735,2017,6,18,xyz,2046-06-18
7441,3327,4114,2017,6,19,xyz,2046-06-19
9259,9847,-588,2017,6,20,xyz,2046-06-20
7073,5400,1673,2017,6,21,xyz,2046-06-21
1429,8391,-6962,2017,6,22,xyz,2046-06-22
5017,2433,2584,2017,6,23,xyz,2046-06-23
4018,5248,-1230,2017,6,24,xyz,2046-06-24
7370,4476,2894,2017,6,25,xyz,2046-06-25
9959,4820,5139,2017,6,26,xyz,2046-06-26
8291,9449,-1158,2017,6,27,xyz,2046-06-27
5552,3060,2492,2017,6,28,xyz,2046-06-28
5489,6669,-1180,2017,6,29,xyz,2046-06-29
4432,7211,-2779,2017,6,30,xyz,2046-06-30
7972,5758,2214,2017,7,1,xyz,2046-07-01
6716,696,6020,2017,7,2,xyz,2046-07-02
5855,8456,-2601,2017,7,3,xyz,2046-07-03
7139,7669,-530,2017,7,4,xyz,2046-07-04
2101,7797,-5696,2017,7,5,xyz,2046-07-05
8306,3530,4776,2017,7,6,xyz,2046-07-06
2333,8041,-5708,2017,7,7,xyz,2046-07-07
1239,506,733,2017,7,8,xyz,2046-07-08
1552,7657,-6105,2017,7,9,xyz,2046-07-09
6397,8141,-1744,2017,7,10,xyz,2046-07-10
3332,7671,-4339,2017,7,11,xyz,2046-07-11
8099,6110,1989,2017,7,12,xyz,2046-07-12
5706,6765,-1059,2017,7,13,xyz,2046-07-13
1539,4760,-3221,2017,7,14,xyz,2046-07-14
7624,8384,-760,2017,7,15,xyz,2046-07-15
9504,3484,6020,2017,7,16,xyz,2046-07-16
9832,4203,5629,2017,7,17,xyz,2046-07-17
5480,3339,2141,2017,7,18,xyz,2046-07-18
9401,2114,7287,2017,7,19,xyz,2046-07-19
4969,5832,-863,2017,7,20,xyz,2046-07-20
4823,8100,-3277,2017,7,21,xyz,2046-07-21
8506,2702,5804,2017,7,22,xyz,2046-07-22
2592,1687,905,2017,7,23,xyz,2046-07-23
5761,8436,-2675,2017,7,24,xyz,2046-07-24
3875,4112,-237,2017,7,25,xyz,2046-07-25
6377,2878,3499,2017,7,26,xyz,2046-07-26
6132,9877,-3745,2017,7,27,xyz,2046-07-27
4937,4170,767,2017,7,28,xyz,2046-07-28
5011,6840,-1829,2017,7,29,xyz,2046-07-29
6562,5327,1235,2017,7,30,xyz,2046-07-30
3376,2603,773,2017,7,31,xyz,2046-07-31
8714,5754,2960,2017,8,1,xyz,2046-08-01
1100,4248,-3148,2017,8,2,xyz,2046-08-02
9471,7038,2433,2017,8,3,xyz,2046-08-03
6018,2371,3647,2017,8,4,xyz,2046-08-04
8523,4194,4329,2017,8,5,xyz,2046-08-05
3963,7368,-3405,2017,8,6,xyz,2046-08-06
2223,8532,-6309,2017,8,7,xyz,2046-08-07
7329,3866,3463,2017,8,8,xyz,2046-08-08
2229,5259,-3030,2017,8,9,xyz,2046-08-09
2659,1195,1464,2017,8,10,xyz,2046-08-10
8237,2406,5831,2017,8,11,xyz,2046-08-11
2021,7055,-5034,2017,8,12,xyz,2046-08-12
1764,5089,-3325,2017,8,13,xyz,2046-08-13
3835,5895,-2060,2017,8,14,xyz,2046-08-14
9076,5727,3349,2017,8,15,xyz,2046-08-15
9835,1446,8389,2017,8,16,xyz,2046-08-16
1508,1329,179,2017,8,17,xyz,2046-08-17
8926,3903,5023,2017,8,18,xyz,2046-08-18
6533,2310,4223,2017,8,19,xyz,2046-08-19
4685,2411,2274,2017,8,20,xyz,2046-08-20
4399,9159,-4760,2017,8,21,xyz,2046-08-21
3003,2815,188,2017,8,22,xyz,2046-08-22
9972,3067,6905,2017,8,23,xyz,2046-08-23
9683,1073,8610,2017,8,24,xyz,2046-08-24
5702,7804,-2102,2017,8,25,xyz,2046-08-25
8714,3813,4901,2017,8,26,xyz,2046-08-26
9589,4479,5110,2017,8,27,xyz,2046-08-27
6968,2509,4459,2017,8,28,xyz,2046-08-28
1626,2959,-1333,2017,8,29,xyz,2046-08-29
8757,2278,6479,2017,8,30,xyz,2046-08-30
8967,2270,6697,2017,8,31,xyz,2046-08-31
9208,1151,8057,2017,9,1,xyz,2046-09-01
6134,5674,460,2017,9,2,xyz,2046-09-02
8334,1699,6635,2017,9,3,xyz,2046-09-03
7703,8673,-970,2017,9,4,xyz,2046-09-04
1565,9999,-8434,2017,9,5,xyz,2046-09-05
2655,1562,1093,2017,9,6,xyz,2046-09-06
8733,5122,3611,2017,9,7,xyz,2046-09-07
3484,8058,-4574,2017,9,8,xyz,2046-09-08
9161,4748,4413,2017,9,9,xyz,2046-09-09
5894,7127,-1233,2017,9,10,xyz,2046-09-10
6374,4462,1912,2017,9,11,xyz,2046-09-11
6894,8008,-1114,2017,9,12,xyz,2046-09-12
9285,685,8600,2017,9,13,xyz,2046-09-13
2384,2609,-225,2017,9,14,xyz,2046-09-14
9487,1685,7802,2017,9,15,xyz,2046-09-15
8529,1245,7284,2017,9,16,xyz,2046-09-16
3995,2052,1943,2017,9,17,xyz,2046-09-17
3414,8806,-5392,2017,9,18,xyz,2046-09-18
9304,951,8353,2017,9,19,xyz,2046-09-19
7112,3617,3495,2017,9,20,xyz,2046-09-20
2537,8652,-6115,2017,9,21,xyz,2046-09-21
7690,9627,-1937,2017,9,22,xyz,2046-09-22
5663,3073,2590,2017,9,23,xyz,2046-09-23
9770,8637,1133,2017,9,24,xyz,2046-09-24
4937,7140,-2203,2017,9,25,xyz,2046-09-25
9058,6588,2470,2017,9,26,xyz,2046-09-26
8034,9448,-1414,2017,9,27,xyz,2046-09-27
7756,2126,5630,2017,9,28,xyz,2046-09-28
4847,3259,1588,2017,9,29,xyz,2046-09-29
4994,961,4033,2017,9,30,xyz,2046-09-30
2074,1619,455,2017,10,1,xyz,2046-10-01
2261,5107,-2846,2017,10,2,xyz,2046-10-02
2107,6398,-4291,2017,10,3,xyz,2046-10-03
8000,980,7020,2017,10,4,xyz,2046-10-04
1983,3015,-1032,2017,10,5,xyz,2046-10-05
4475,1879,2596,2017,10,6,xyz,2046-10-06
3068,1534,1534,2017,10,7,xyz,2046-10-07
6275,1947,4328,2017,10,8,xyz,2046-10-08
6628,6134,494,2017,10,9,xyz,2046-10-09
1736,3605,-1869,2017,10,10,xyz,2046-10-10
3998,9248,-5250,2017,10,11,xyz,2046-10-11
4445,9495,-5050,2017,10,12,xyz,2046-10-12
9629,3281,6348,2017,10,13,xyz,2046-10-13
8913,8502,411,2017,10,14,xyz,2046-10-14
8732,5568,3164,2017,10,15,xyz,2046-10-15
1067,8176,-7109,2017,10,16,xyz,2046-10-16
7290,2707,4583,2017,10,17,xyz,2046-10-17
5658,8044,-2386,2017,10,18,xyz,2046-10-18
3091,8166,-5075,2017,10,19,xyz,2046-10-19
1396,7634,-6238,2017,10,20,xyz,2046-10-20
2715,8426,-5711,2017,10,21,xyz,2046-10-21
9220,1196,8024,2017,10,22,xyz,2046-10-22
3176,1377,1799,2017,10,23,xyz,2046-10-23
1881,2603,-722,2017,10,24,xyz,2046-10-24
2226,3298,-1072,2017,10,25,xyz,2046-10-25
8970,5922,3048,2017,10,26,xyz,2046-10-26
1673,631,1042,2017,10,27,xyz,2046-10-27
9093,2096,6997,2017,10,28,xyz,2046-10-28
8045,5356,2689,2017,10,29,xyz,2046-10-29
1163,8261,-7098,2017,10,30,xyz,2046-10-30
7475,1157,6318,2017,10,31,xyz,2046-10-31
2909,4275,-1366,2017,11,1,xyz,2046-11-01
1814,4461,-2647,2017,11,2,xyz,2046-11-02
9059,1592,7467,2017,11,3,xyz,2046-11-03
5173,1878,3295,2017,11,4,xyz,2046-11-04
1658,6899,-5241,2017,11,5,xyz,2046-11-05
9772,3464,6308,2017,11,6,xyz,2046-11-06
7746,3145,4601,2017,11,7,xyz,2046-11-07
9682,2157,7525,2017,11,8,xyz,2046-11-08
5580,4041,1539,2017,11,9,xyz,2046-11-09
9619,5705,3914,2017,11,10,xyz,2046-11-10
7530,2540,4990,2017,11,11,xyz,2046-11-11
8716,9110,-394,2017,11,12,xyz,2046-11-12
4846,9611,-4765,2017,11,13,xyz,2046-11-13
6769,3234,3535,2017,11,14,xyz,2046-11-14
4093,7577,-3484,2017,11,15,xyz,2046-11-15
3457,7159,-3702,2017,11,16,xyz,2046-11-16
7696,9106,-1410,2017,11,17,xyz,2046-11-17
3642,967,2675,2017,11,18,xyz,2046-11-18
3439,4096,-657,2017,11,19,xyz,2046-11-19
9921,4897,5024,2017,11,20,xyz,2046-11-20
8362,5263,3099,2017,11,21,xyz,2046-11-21
6293,5090,1203,2017,11,22,xyz,2046-11-22
2003,8336,-6333,2017,11,23,xyz,2046-11-23
7282,860,6422,2017,11,24,xyz,2046-11-24
3487,6092,-2605,2017,11,25,xyz,2046-11-25
1114,8412,-7298,2017,11,26,xyz,2046-11-26
6924,2979,3945,2017,11,27,xyz,2046-11-27
4534,3439,1095,2017,11,28,xyz,2046-11-28
4126,3867,259,2017,11,29,xyz,2046-11-29
1357,7485,-6128,2017,11,30,xyz,2046-11-30
2875,7225,-4350,2017,12,1,xyz,2046-12-01
9660,6667,2993,2017,12,2,xyz,2046-12-02
3352,7820,-4468,2017,12,3,xyz,2046-12-03
1653,5697,-4044,2017,12,4,xyz,2046-12-04
6174,9439,-3265,2017,12,5,xyz,2046-12-05
2004,551,1453,2017,12,6,xyz,2046-12-06
4346,1334,3012,2017,12,7,xyz,2046-12-07
6747,8260,-1513,2017,12,8,xyz,2046-12-08
3870,6671,-2801,2017,12,9,xyz,2046-12-09
1393,2046,-653,2017,12,10,xyz,2046-12-10
9093,4400,4693,2017,12,11,xyz,2046-12-11
7862,1942,5920,2017,12,12,xyz,2046-12-12
2448,7237,-4789,2017,12,13,xyz,2046-12-13
8449,8919,-470,2017,12,14,xyz,2046-12-14
6240,4714,1526,2017,12,15,xyz,2046-12-15
5279,3142,2137,2017,12,16,xyz,2046-12-16
1849,4419,-2570,2017,12,17,xyz,2046-12-17
8120,2935,5185,2017,12,18,xyz,2046-12-18
5977,5688,289,2017,12,19,xyz,2046-12-19
8296,1143,7153,2017,12,20,xyz,2046-12-20
9375,6292,3083,2017,12,21,xyz,2046-12-21
7836,8822,-986,2017,12,22,xyz,2046-12-22
2280,1565,715,2017,12,23,xyz,2046-12-23
6540,6334,206,2017,12,24,xyz,2046-12-24
3586,2661,925,2017,12,25,xyz,2046-12-25
7389,6135,1254,2017,12,26,xyz,2046-12-26
2524,9645,-7121,2017,12,27,xyz,2046-12-27
8702,1647,7055,2017,12,28,xyz,2046-12-28
9144,6854,2290,2017,12,29,xyz,2046-12-29
4679,4398,281,2017,12,30,xyz,2046-12-30
7153,5994,1159,2017,12,31,xyz,2046-12-31
2319,8154,-5835,2018,1,1,xyz,2047-01-01
3445,1405,2040,2018,1,2,xyz,2047-01-02
3526,3646,-120,2018,1,3,xyz,2047-01-03
8201,8851,-650,2018,1,4,xyz,2047-01-04
9898,4484,5414,2018,1,5,xyz,2047-01-05
4233,9972,-5739,2018,1,6,xyz,2047-01-06
2047,8418,-6371,2018,1,7,xyz,2047-01-07
7310,7780,-470,2018,1,8,xyz,2047-01-08
8542,5920,2622,2018,1,9,xyz,2047-01-09
9934,676,9258,2018,1,10,xyz,2047-01-10
4535,3494,1041,2018,1,11,xyz,2047-01-11
4447,1294,3153,2018,1,12,xyz,2047-01-12
3649,5969,-2320,2018,1,13,xyz,2047-01-13
2756,2977,-221,2018,1,14,xyz,2047-01-14
8287,1005,7282,2018,1,15,xyz,2047-01-15
6636,1745,4891,2018,1,16,xyz,2047-01-16
3217,5480,-2263,2018,1,17,xyz,2047-01-17
6323,3988,2335,2018,1,18,xyz,2047-01-18
8440,1560,6880,2018,1,19,xyz,2047-01-19
2536,7619,-5083,2018,1,20,xyz,2047-01-20
6815,856,5959,2018,1,21,xyz,2047-01-21
7164,7604,-440,2018,1,22,xyz,2047-01-22
8497,2030,6467,2018,1,23,xyz,2047-01-23
7199,8223,-1024,2018,1,24,xyz,2047-01-24
1507,9495,-7988,2018,1,25,xyz,2047-01-25
8702,6933,1769,2018,1,26,xyz,2047-01-26
6485,941,5544,2018,1,27,xyz,2047-01-27
4685,5877,-1192,2018,1,28,xyz,2047-01-28
3632,6488,-2856,2018,1,29,xyz,2047-01-29
8499,4076,4423,2018,1,30,xyz,2047-01-30
1507,6115,-4608,2018,1,31,xyz,2047-01-31
3534,6005,-2471,2018,2,1,xyz,2047-02-01
3624,3116,508,2018,2,2,xyz,2047-02-02
3415,6660,-3245,2018,2,3,xyz,2047-02-03
2166,7931,-5765,2018,2,4,xyz,2047-02-04
4641,3603,1038,2018,2,5,xyz,2047-02-05
5143,3157,1986,2018,2,6,xyz,2047-02-06
6312,3623,2689,2018,2,7,xyz,2047-02-07
3230,7184,-3954,2018,2,8,xyz,2047-02-08
9771,8654,1117,2018,2,9,xyz,2047-02-09
3748,7496,-3748,2018,2,10,xyz,2047-02-10
4907,3652,1255,2018,2,11,xyz,2047-02-11
7397,7070,327,2018,2,12,xyz,2047-02-12
7078,5531,1547,2018,2,13,xyz,2047-02-13
7404,4754,2650,2018,2,14,xyz,2047-02-14
2130,5808,-3678,2018,2,15,xyz,2047-02-15
6813,5013,1800,2018,2,16,xyz,2047-02-16
5001,5374,-373,2018,2,17,xyz,2047-02-17
4982,5795,-813,2018,2,18,xyz,2047-02-18
6062,3071,2991,2018,2,19,xyz,2047-02-19
5442,1558,3884,2018,2,20,xyz,2047-02-20
7988,9176,-1188,2018,2,21,xyz,2047-02-21
9597,9606,-9,2018,2,22,xyz,2047-02-22
4365,4315,50,2018,2,23,xyz,2047-02-23
8544,1369,7175,2018,2,24,xyz,2047-02-24
1139,8692,-7553,2018,2,25,xyz,2047-02-25
5222,1670,3552,2018,2,26,xyz,2047-02-26
1701,3910,-2209,2018,2,27,xyz,2047-02-27
8631,9968,-1337,2018,2,28,xyz,2047-02-28
9588,9989,-401,2018,3,1,xyz,2047-03-01
9112,9942,-830,2018,3,2,xyz,2047-03-02
4627,7637,-3010,2018,3,3,xyz,2047-03-03
9788,6693,3095,2018,3,4,xyz,2047-03-04
5687,7877,-2190,2018,3,5,xyz,2047-03-05
9916,4061,5855,2018,3,6,xyz,2047-03-06
7798,6692,1106,2018,3,7,xyz,2047-03-07
7579,3416,4163,2018,3,8,xyz,2047-03-08
1192,6043,-4851,2018,3,9,xyz,2047-03-09
5376,6801,-1425,2018,3,10,xyz,2047-03-10
9395,3615,5780,2018,3,11,xyz,2047-03-11
1341,9355,-8014,2018,3,12,xyz,2047-03-12
2819,6417,-3598,2018,3,13,xyz,2047-03-13
6095,4955,1140,2018,3,14,xyz,2047-03-14
4235,7066,-2831,2018,3,15,xyz,2047-03-15
2763,8554,-5791,2018,3,16,xyz,2047-03-16
7462,7722,-260,2018,3,17,xyz,2047-03-17
2114,5302,-3188,2018,3,18,xyz,2047-03-18
6490,2371,4119,2018,3,19,xyz,2047-03-19
7436,7152,284,2018,3,20,xyz,2047-03-20
4232,9083,-4851,2018,3,21,xyz,2047-03-21
6556,850,5706,2018,3,22,xyz,2047-03-22
1306,7006,-5700,2018,3,23,xyz,2047-03-23
8850,9420,-570,2018,3,24,xyz,2047-03-24
3159,8785,-5626,2018,3,25,xyz,2047-03-25
1845,9177,-7332,2018,3,26,xyz,2047-03-26
4369,4380,-11,2018,3,27,xyz,2047-03-27
3310,2161,1149,2018,3,28,xyz,2047-03-28
3515,9145,-5630,2018,3,29,xyz,2047-03-29
6761,6409,352,2018,3,30,xyz,2047-03-30
6442,5447,995,2018,3,31,xyz,2047-03-31
1189,9498,-8309,2018,4,1,xyz,2047-04-01
7724,9983,-2259,2018,4,2,xyz,2047-04-02
5979,6683,-704,2018,4,3,xyz,2047-04-03
6526,3510,3016,2018,4,4,xyz,2047-04-04
3439,2952,487,2018,4,5,xyz,2047-04-05
4096,3045,1051,2018,4,6,xyz,2047-04-06
5517,6655,-1138,2018,4,7,xyz,2047-04-07
2130,6673,-4543,2018,4,8,xyz,2047-04-08
6833,8486,-1653,2018,4,9,xyz,2047-04-09
2932,2564,368,2018,4,10,xyz,2047-04-10
3580,4865,-1285,2018,4,11,xyz,2047-04-11
6180,4449,1731,2018,4,12,xyz,2047-04-12
9795,4742,5053,2018,4,13,xyz,2047-04-13
2958,5546,-2588,2018,4,14,xyz,2047-04-14
9049,2036,7013,2018,4,15,xyz,2047-04-15
6541,3266,3275,2018,4,16,xyz,2047-04-16
9459,5656,3803,2018,4,17,xyz,2047-04-17
1383,874,509,2018,4,18,xyz,2047-04-18
8633,7257,1376,2018,4,19,xyz,2047-04-19
1383,1714,-331,2018,4,20,xyz,2047-04-20
4937,5993,-1056,2018,4,21,xyz,2047-04-21
1612,795,817,2018,4,22,xyz,2047-04-22
2998,7999,-5001,2018,4,23,xyz,2047-04-23
5093,4738,355,2018,4,24,xyz,2047-04-24
5736,1347,4389,2018,4,25,xyz,2047-04-25
7245,3892,3353,2018,4,26,xyz,2047-04-26
5493,6413,-920,2018,4,27,xyz,2047-04-27
5055,4227,828,2018,4,28,xyz,2047-04-28
9407,1259,8148,2018,4,29,xyz,2047-04-29
1574,3180,-1606,2018,4,30,xyz,2047-04-30
5070,2596,2474,2018,5,1,xyz,2047-05-01
8637,8095,542,2018,5,2,xyz,2047-05-02
1493,7372,-5879,2018,5,3,xyz,2047-05-03
5400,9274,-3874,2018,5,4,xyz,2047-05-04
6015,2100,3915,2018,5,5,xyz,2047-05-05
1276,2490,-1214,2018,5,6,xyz,2047-05-06
9677,8665,1012,2018,5,7,xyz,2047-05-07
7610,6635,975,2018,5,8,xyz,2047-05-08
8233,6686,1547,2018,5,9,xyz,2047-05-09
3720,2706,1014,2018,5,10,xyz,2047-05-10
3966,7822,-3856,2018,5,11,xyz,2047-05-11
3757,8186,-4429,2018,5,12,xyz,2047-05-12
9879,2181,7698,2018,5,13,xyz,2047-05-13
8133,3644,4489,2018,5,14,xyz,2047-05-14
3299,9031,-5732,2018,5,15,xyz,2047-05-15
2212,6806,-4594,2018,5,16,xyz,2047-05-16
8216,1730,6486,2018,5,17,xyz,2047-05-17
8791,7928,863,2018,5,18,xyz,2047-05-18
8483,4681,3802,2018,5,19,xyz,2047-05-19
7087,8954,-1867,2018,5,20,xyz,2047-05-20
9261,986,8275,2018,5,21,xyz,2047-05-21
7833,6404,1429,2018,5,22,xyz,2047-05-22
7574,1191,6383,2018,5,23,xyz,2047-05-23
6718,9045,-2327,2018,5,24,xyz,2047-05-24
8482,8668,-186,2018,5,25,xyz,2047-05-25
9635,4585,5050,2018,5,26,xyz,2047-05-26
8068,5619,2449,2018,5,27,xyz,2047-05-27
2982,6073,-3091,2018,5,28,xyz,2047-05-28
5276,7567,-2291,2018,5,29,xyz,2047-05-29
3920,3840,80,2018,5,30,xyz,2047-05-30
2128,3986,-1858,2018,5,31,xyz,2047-05-31
6468,9127,-2659,2018,6,1,xyz,2047-06-01
1219,2091,-872,2018,6,2,xyz,2047-06-02
5480,5760,-280,2018,6,3,xyz,2047-06-03
3873,5153,-1280,2018,6,4,xyz,2047-06-04
6344,543,5801,2018,6,5,xyz,2047-06-05
4774,6511,-1737,2018,6,6,xyz,2047-06-06
1800,7557,-5757,2018,6,7,xyz,2047-06-07
3492,4355,-863,2018,6,8,xyz,2047-06-08
8294,5759,2535,2018,6,9,xyz,2047-06-09
7771,7845,-74,2018,6,10,xyz,2047-06-10
3075,6583,-3508,2018,6,11,xyz,2047-06-11
6553,8457,-1904,2018,6,12,xyz,2047-06-12
1892,3255,-1363,2018,6,13,xyz,2047-06-13
9916,2258,7658,2018,6,14,xyz,2047-06-14
4445,8236,-3791,2018,6,15,xyz,2047-06-15
8092,5544,2548,2018,6,16,xyz,2047-06-16
2984,9631,-6647,2018,6,17,xyz,2047-06-17
4482,6879,-2397,2018,6,18,xyz,2047-06-18
2700,5146,-2446,2018,6,19,xyz,2047-06-19
1723,2850,-1127,2018,6,20,xyz,2047-06-20
9827,4976,4851,2018,6,21,xyz,2047-06-21
8738,9351,-613,2018,6,22,xyz,2047-06-22
9599,5559,4040,2018,6,23,xyz,2047-06-23
3700,6705,-3005,2018,6,24,xyz,2047-06-24
2775,7167,-4392,2018,6,25,xyz,2047-06-25
7203,1665,5538,2018,6,26,xyz,2047-06-26
8008,4148,3860,2018,6,27,xyz,2047-06-27
7909,4742,3167,2018,6,28,xyz,2047-06-28
8965,9915,-950,2018,6,29,xyz,2047-06-29
1404,1833,-429,2018,6,30,xyz,2047-06-30
6251,738,5513,2018,7,1,xyz,2047-07-01
1363,9703,-8340,2018,7,2,xyz,2047-07-02
4867,4357,510,2018,7,3,xyz,2047-07-03
8099,8947,-848,2018,7,4,xyz,2047-07-04
2149,7579,-5430,2018,7,5,xyz,2047-07-05
8125,2630,5495,2018,7,6,xyz,2047-07-06
6661,6774,-113,2018,7,7,xyz,2047-07-07
5390,5542,-152,2018,7,8,xyz,2047-07-08
4710,4749,-39,2018,7,9,xyz,2047-07-09
6789,7596,-807,2018,7,10,xyz,2047-07-10
5645,1047,4598,2018,7,11,xyz,2047-07-11
5279,5625,-346,2018,7,12,xyz,2047-07-12
4441,7164,-2723,2018,7,13,xyz,2047-07-13
5192,6303,-1111,2018,7,14,xyz,2047-07-14
3567,9391,-5824,2018,7,15,xyz,2047-07-15
9706,6858,2848,2018,7,16,xyz,2047-07-16
7934,6214,1720,2018,7,17,xyz,2047-07-17
4730,4960,-230,2018,7,18,xyz,2047-07-18
6284,9657,-3373,2018,7,19,xyz,2047-07-19
7171,6172,999,2018,7,20,xyz,2047-07-20
5518,620,4898,2018,7,21,xyz,2047-07-21
3772,6225,-2453,2018,7,22,xyz,2047-07-22
9826,9713,113,2018,7,23,xyz,2047-07-23
3328,5395,-2067,2018,7,24,xyz,2047-07-24
8632,3105,5527,2018,7,25,xyz,2047-07-25
3192,4835,-1643,2018,7,26,xyz,2047-07-26
7993,2831,5162,2018,7,27,xyz,2047-07-27
4253,3290,963,2018,7,28,xyz,2047-07-28
4380,4978,-598,2018,7,29,xyz,2047-07-29
2559,8642,-6083,2018,7,30,xyz,2047-07-30
5874,8896,-3022,2018,7,31,xyz,2047-07-31
4713,9072,-4359,2018,8,1,xyz,2047-08-01
6567,4296,2271,2018,8,2,xyz,2047-08-02
2399,7528,-5129,2018,8,3,xyz,2047-08-03
8742,4879,3863,2018,8,4,xyz,2047-08-04
8364,6012,2352,2018,8,5,xyz,2047-08-05
3660,2935,725,2018,8,6,xyz,2047-08-06
8988,8577,411,2018,8,7,xyz,2047-08-07
1176,5481,-4305,2018,8,8,xyz,2047-08-08
8282,1203,7079,2018,8,9,xyz,2047-08-09
5526,8871,-3345,2018,8,10,xyz,2047-08-10
3250,9698,-6448,2018,8,11,xyz,2047-08-11
2025,8266,-6241,2018,8,12,xyz,2047-08-12
9756,6395,3361,2018,8,13,xyz,2047-08-13
9657,6099,3558,2018,8,14,xyz,2047-08-14
4304,5034,-730,2018,8,15,xyz,2047-08-15
7977,7470,507,2018,8,16,xyz,2047-08-16
6419,8674,-2255,2018,8,17,xyz,2047-08-17
6626,9578,-2952,2018,8,18,xyz,2047-08-18
9211,3313,5898,2018,8,19,xyz,2047-08-19
1798,1159,639,2018,8,20,xyz,2047-08-20
8277,5036,3241,2018,8,21,xyz,2047-08-21
7451,6772,679,2018,8,22,xyz,2047-08-22
3969,908,3061,2018,8,23,xyz,2047-08-23
5168,3652,1516,2018,8,24,xyz,2047-08-24
7949,832,7117,2018,8,25,xyz,2047-08-25
1033,4325,-3292,2018,8,26,xyz,2047-08-26
8607,1324,7283,2018,8,27,xyz,2047-08-27
1872,3452,-1580,2018,8,28,xyz,2047-08-28
9977,4593,5384,2018,8,29,xyz,2047-08-29
7521,5911,1610,2018,8,30,xyz,2047-08-30
3520,6030,-2510,2018,8,31,xyz,2047-08-31
8184,6301,1883,2018,9,1,xyz,2047-09-01
8248,4181,4067,2018,9,2,xyz,2047-09-02
8394,3114,5280,2018,9,3,xyz,2047-09-03
1866,8889,-7023,2018,9,4,xyz,2047-09-04
6728,1519,5209,2018,9,5,xyz,2047-09-05
7395,5815,1580,2018,9,6,xyz,2047-09-06
8050,9397,-1347,2018,9,7,xyz,2047-09-07
4623,5650,-1027,2018,9,8,xyz,2047-09-08
5002,1993,3009,2018,9,9,xyz,2047-09-09
8906,7167,1739,2018,9,10,xyz,2047-09-10
6726,1072,5654,2018,9,11,xyz,2047-09-11
8251,7281,970,2018,9,12,xyz,2047-09-12
2273,8742,-6469,2018,9,13,xyz,2047-09-13
7841,7356,485,2018,9,14,xyz,2047-09-14
2177,4219,-2042,2018,9,15,xyz,2047-09-15
9659,2167,7492,2018,9,16,xyz,2047-09-16
5082,6993,-1911,2018,9,17,xyz,2047-09-17
6990,627,6363,2018,9,18,xyz,2047-09-18
6880,741,6139,2018,9,19,xyz,2047-09-19
8501,3674,4827,2018,9,20,xyz,2047-09-20
8694,5203,3491,2018,9,21,xyz,2047-09-21
8523,9628,-1105,2018,9,22,xyz,2047-09-22
5741,4582,1159,2018,9,23,xyz,2047-09-23
3148,1479,1669,2018,9,24,xyz,2047-09-24
9863,4288,5575,2018,9,25,xyz,2047-09-25
9751,1397,8354,2018,9,26,xyz,2047-09-26
5337,2628,2709,2018,9,27,xyz,2047-09-27
2643,2403,240,2018,9,28,xyz,2047-09-28
6072,6592,-520,2018,9,29,xyz,2047-09-29
8317,1985,6332,2018,9,30,xyz,2047-09-30
2383,7398,-5015,2018,10,1,xyz,2047-10-01
3152,8945,-5793,2018,10,2,xyz,2047-10-02
4784,9597,-4813,2018,10,3,xyz,2047-10-03
2063,9688,-7625,2018,10,4,xyz,2047-10-04
6730,9848,-3118,2018,10,5,xyz,2047-10-05
8136,5030,3106,2018,10,6,xyz,2047-10-06
7262,3488,3774,2018,10,7,xyz,2047-10-07
1167,4476,-3309,2018,10,8,xyz,2047-10-08
5066,8626,-3560,2018,10,9,xyz,2047-10-09
2103,7329,-5226,2018,10,10,xyz,2047-10-10
7061,1162,5899,2018,10,11,xyz,2047-10-11
1630,7725,-6095,2018,10,12,xyz,2047-10-12
4793,3521,1272,2018,10,13,xyz,2047-10-13
8174,903,7271,2018,10,14,xyz,2047-10-14
4624,553,4071,2018,10,15,xyz,2047-10-15
6555,3220,3335,2018,10,16,xyz,2047-10-16
2937,4215,-1278,2018,10,17,xyz,2047-10-17
8646,1601,7045,2018,10,18,xyz,2047-10-18
8085,3890,4195,2018,10,19,xyz,2047-10-19
4571,4819,-248,2018,10,20,xyz,2047-10-20
7392,6324,1068,2018,10,21,xyz,2047-10-21
3254,6896,-3642,2018,10,22,xyz,2047-10-22
2760,1984,776,2018,10,23,xyz,2047-10-23
4588,9839,-5251,2018,10,24,xyz,2047-10-24
4375,8650,-4275,2018,10,25,xyz,2047-10-25
5517,3997,1520,2018,10,26,xyz,2047-10-26
2408,9766,-7358,2018,10,27,xyz,2047-10-27
7862,9585,-1723,2018,10,28,xyz,2047-10-28
2546,6178,-3632,2018,10,29,xyz,2047-10-29
2863,7639,-4776,2018,10,30,xyz,2047-10-30
9587,9888,-301,2018,10,31,xyz,2047-10-31
7116,6652,464,2018,11,1,xyz,2047-11-01
3221,7543,-4322,2018,11,2,xyz,2047-11-02
4652,5945,-1293,2018,11,3,xyz,2047-11-03
1530,2062,-532,2018,11,4,xyz,2047-11-04
6296,8418,-2122,2018,11,5,xyz,2047-11-05
1517,587,930,2018,11,6,xyz,2047-11-06
10000,9986,14,2018,11,7,xyz,2047-11-07
3595,1316,2279,2018,11,8,xyz,2047-11-08
5747,1820,3927,2018,11,9,xyz,2047-11-09
3339,9310,-5971,2018,11,10,xyz,2047-11-10
3267,8435,-5168,2018,11,11,xyz,2047-11-11
2096,7231,-5135,2018,11,12,xyz,2047-11-12
6528,4073,2455,2018,11,13,xyz,2047-11-13
7830,7022,808,2018,11,14,xyz,2047-11-14
7514,8891,-1377,2018,11,15,xyz,2047-11-15
1691,8105,-6414,2018,11,16,xyz,2047-11-16
4050,3627,423,2018,11,17,xyz,2047-11-17
5892,2758,3134,2018,11,18,xyz,2047-11-18
3807,1267,2540,2018,11,19,xyz,2047-11-19
4588,520,4068,2018,11,20,xyz,2047-11-20
7430,4182,3248,2018,11,21,xyz,2047-11-21
6827,8722,-1895,2018,11,22,xyz,2047-11-22
9009,4951,4058,2018,11,23,xyz,2047-11-23
4829,5067,-238,2018,11,24,xyz,2047-11-24
1201,9271,-8070,2018,11,25,xyz,2047-11-25
9449,2822,6627,2018,11,26,xyz,2047-11-26
4165,5328,-1163,2018,11,27,xyz,2047-11-27
9634,6548,3086,2018,11,28,xyz,2047-11-28
1710,5819,-4109,2018,11,29,xyz,2047-11-29
8002,3695,4307,2018,11,30,xyz,2047-11-30
2718,1934,784,2018,12,1,xyz,2047-12-01
7885,2858,5027,2018,12,2,xyz,2047-12-02
9597,3938,5659,2018,12,3,xyz,2047-12-03
6837,4687,2150,2018,12,4,xyz,2047-12-04
7982,4519,3463,2018,12,5,xyz,2047-12-05
9935,1087,8848,2018,12,6,xyz,2047-12-06
9235,4823,4412,2018,12,7,xyz,2047-12-07
1659,9176,-7517,2018,12,8,xyz,2047-12-08
9305,1420,7885,2018,12,9,xyz,2047-12-09
4491,5214,-723,2018,12,10,xyz,2047-12-10
4033,3730,303,2018,12,11,xyz,2047-12-11
1245,2804,-1559,2018,12,12,xyz,2047-12-12
6392,9298,-2906,2018,12,13,xyz,2047-12-13
2149,9103,-6954,2018,12,14,xyz,2047-12-14
6364,8230,-1866,2018,12,15,xyz,2047-12-15
7261,581,6680,2018,12,16,xyz,2047-12-16
1147,4228,-3081,2018,12,17,xyz,2047-12-17
1664,1543,121,2018,12,18,xyz,2047-12-18
4053,2223,1830,2018,12,19,xyz,2047-12-19
3006,6252,-3246,2018,12,20,xyz,2047-12-20
3098,5986,-2888,2018,12,21,xyz,2047-12-21
8960,2110,6850,2018,12,22,xyz,2047-12-22
5447,4524,923,2018,12,23,xyz,2047-12-23
7568,1296,6272,2018,12,24,xyz,2047-12-24
3163,2206,957,2018,12,25,xyz,2047-12-25
1602,1420,182,2018,12,26,xyz,2047-12-26
8562,2927,5635,2018,12,27,xyz,2047-12-27
6837,1734,5103,2018,12,28,xyz,2047-12-28
5179,2968,2211,2018,12,29,xyz,2047-12-29
2311,5043,-2732,2018,12,30,xyz,2047-12-30
9248,9389,-141,2018,12,31,xyz,2047-12-31
4394,4036,358,2019,1,1,xyz,2048-01-01
1606,7719,-6113,2019,1,2,xyz,2048-01-02
4043,3453,590,2019,1,3,xyz,2048-01-03
9756,7721,2035,2019,1,4,xyz,2048-01-04
8938,3282,5656,2019,1,5,xyz,2048-01-05
9254,2338,6916,2019,1,6,xyz,2048-01-06
4921,9283,-4362,2019,1,7,xyz,2048-01-07
7657,883,6774,2019,1,8,xyz,2048-01-08
1646,971,675,2019,1,9,xyz,2048-01-09
2861,7529,-4668,2019,1,10,xyz,2048-01-10
5151,7796,-2645,2019,1,11,xyz,2048-01-11
8160,9530,-1370,2019,1,12,xyz,2048-01-12
2126,6285,-4159,2019,1,13,xyz,2048-01-13
4719,5959,-1240,2019,1,14,xyz,2048-01-14
3527,5265,-1738,2019,1,15,xyz,2048-01-15
6584,6745,-161,2019,1,16,xyz,2048-01-16
1704,3634,-1930,2019,1,17,xyz,2048-01-17
3483,6104,-2621,2019,1,18,xyz,2048-01-18
2590,9153,-6563,2019,1,19,xyz,2048-01-19
2192,7818,-5626,2019,1,20,xyz,2048-01-20
3956,9460,-5504,2019,1,21,xyz,2048-01-21
1239,7097,-5858,2019,1,22,xyz,2048-01-22
5435,8938,-3503,2019,1,23,xyz,2048-01-23
8586,9994,-1408,2019,1,24,xyz,2048-01-24
4219,1874,2345,2019,1,25,xyz,2048-01-25
9261,9961,-700,2019,1,26,xyz,2048-01-26
2624,3687,-1063,2019,1,27,xyz,2048-01-27
5314,1948,3366,2019,1,28,xyz,2048-01-28
7845,6743,1102,2019,1,29,xyz,2048-01-29
3884,6657,-2773,2019,1,30,xyz,2048-01-30
3137,9684,-6547,2019,1,31,xyz,2048-01-31
1708,858,850,2019,2,1,xyz,2048-02-01
4528,1091,3437,2019,2,2,xyz,2048-02-02
1346,6902,-5556,2019,2,3,xyz,2048-02-03
2017,8606,-6589,2019,2,4,xyz,2048-02-04
5770,4924,846,2019,2,5,xyz,2048-02-05
1914,6036,-4122,2019,2,6,xyz,2048-02-06
3250,9205,-5955,2019,2,7,xyz,2048-02-07
8923,7335,1588,2019,2,8,xyz,2048-02-08
7655,9230,-1575,2019,2,9,xyz,2048-02-09
1178,7928,-6750,2019,2,10,xyz,2048-02-10
7180,2905,4275,2019,2,11,xyz,2048-02-11
5443,1409,4034,2019,2,12,xyz,2048-02-12
2946,5709,-2763,2019,2,13,xyz,2048-02-13
4344,4237,107,2019,2,14,xyz,2048-02-14
4761,3945,816,2019,2,15,xyz,2048-02-15
3338,6389,-3051,2019,2,16,xyz,2048-02-16
6799,3814,2985,2019,2,17,xyz,2048-02-17
3847,782,3065,2019,2,18,xyz,2048-02-18
6882,1390,5492,2019,2,19,xyz,2048-02-19
1995,8843,-6848,2019,2,20,xyz,2048-02-20
1167,6767,-5600,2019,2,21,xyz,2048-02-21
6802,4313,2489,2019,2,22,xyz,2048-02-22
4232,1702,2530,2019,2,23,xyz,2048-02-23
8026,5338,2688,2019,2,24,xyz,2048-02-24
1749,8559,-6810,2019,2,25,xyz,2048-02-25
8291,3981,4310,2019,2,26,xyz,2048-02-26
2813,9296,-6483,2019,2,27,xyz,2048-02-27
3285,7922,-4637,2019,2,28,xyz,2048-02-28
5821,3503,2318,2019,2,29,xyz,2048-02-29
8647,8577,70,2019,3,1,xyz,2048-03-01
1075,7671,-6596,2019,3,2,xyz,2048-03-02
2726,3010,-284,2019,3,3,xyz,2048-03-03
9974,8134,1840,2019,3,4,xyz,2048-03-04
8495,4882,3613,2019,3,5,xyz,2048-03-05
4732,9938,-5206,2019,3,6,xyz,2048-03-06
6069,1605,4464,2019,3,7,xyz,2048-03-07
7799,5160,2639,2019,3,8,xyz,2048-03-08
3530,9730,-6200,2019,3,9,xyz,2048-03-09
3947,2668,1279,2019,3,10,xyz,2048-03-10
2747,6951,-4204,2019,3,11,xyz,2048-03-11
3673,7509,-3836,2019,3,12,xyz,2048-03-12
6235,9530,-3295,2019,3,13,xyz,2048-03-13
9703,6978,2725,2019,3,14,xyz,2048-03-14
5521,6901,-1380,2019,3,15,xyz,2048-03-15
7451,3894,3557,2019,3,16,xyz,2048-03-16
7687,833,6854,2019,3,17,xyz,2048-03-17
8648,3605,5043,2019,3,18,xyz,2048-03-18
7488,7561,-73,2019,3,19,xyz,2048-03-19
5664,6905,-1241,2019,3,20,xyz,2048-03-20
6301,2482,3819,2019,3,21,xyz,2048-03-21
5904,6625,-721,2019,3,22,xyz,2048-03-22
9679,675,9004,2019,3,23,xyz,2048-03-23
5667,4616,1051,2019,3,24,xyz,2048-03-24
8744,2038,6706,2019,3,25,xyz,2048-03-25
5973,5799,174,2019,3,26,xyz,2048-03-26
6189,728,5461,2019,3,27,xyz,2048-03-27
1303,6469,-5166,2019,3,28,xyz,2048-03-28
4119,5121,-1002,2019,3,29,xyz,2048-03-29
4731,3558,1173,2019,3,30,xyz,2048-03-30
5575,2578,2997,2019,3,31,xyz,2048-03-31
9845,5522,4323,2019,4,1,xyz,2048-04-01
4288,9058,-4770,2019,4,2,xyz,2048-04-02
1722,1148,574,2019,4,3,xyz,2048-04-03
4892,6065,-1173,2019,4,4,xyz,2048-04-04
7126,7763,-637,2019,4,5,xyz,2048-04-05
4131,4838,-707,2019,4,6,xyz,2048-04-06
5741,4564,1177,2019,4,7,xyz,2048-04-07
2218,2161,57,2019,4,8,xyz,2048-04-08
8737,8054,683,2019,4,9,xyz,2048-04-09
3900,3356,544,2019,4,10,xyz,2048-04-10
6329,4401,1928,2019,4,11,xyz,2048-04-11
8027,5621,2406,2019,4,12,xyz,2048-04-12
3746,3968,-222,2019,4,13,xyz,2048-04-13
5486,9723,-4237,2019,4,14,xyz,2048-04-14
1245,2673,-1428,2019,4,15,xyz,2048-04-15
5212,3032,2180,2019,4,16,xyz,2048-04-16
6147,8979,-2832,2019,4,17,xyz,2048-04-17
5600,6854,-1254,2019,4,18,xyz,2048-04-18
2783,8287,-5504,2019,4,19,xyz,2048-04-19
6477,2135,4342,2019,4,20,xyz,2048-04-20
9539,1993,7546,2019,4,21,xyz,2048-04-21
5674,2156,3518,2019,4,22,xyz,2048-04-22
8573,6386,2187,2019,4,23,xyz,2048-04-23
2033,3674,-1641,2019,4,24,xyz,2048-04-24
8244,7459,785,2019,4,25,xyz,2048-04-25
7974,9064,-1090,2019,4,26,xyz,2048-04-26
1412,9111,-7699,2019,4,27,xyz,2048-04-27
5095,890,4205,2019,4,28,xyz,2048-04-28
5912,8901,-2989,2019,4,29,xyz,2048-04-29
8866,7148,1718,2019,4,30,xyz,2048-04-30
3964,8023,-4059,2019,5,1,xyz,2048-05-01
2425,6628,-4203,2019,5,2,xyz,2048-05-02
9116,6367,2749,2019,5,3,xyz,2048-05-03
3562,9022,-5460,2019,5,4,xyz,2048-05-04
7134,3948,3186,2019,5,5,xyz,2048-05-05
6481,1852,4629,2019,5,6,xyz,2048-05-06
1174,7728,-6554,2019,5,7,xyz,2048-05-07
1158,1271,-113,2019,5,8,xyz,2048-05-08
2322,1578,744,2019,5,9,xyz,2048-05-09
8829,4635,4194,2019,5,10,xyz,2048-05-10
6469,4806,1663,2019,5,11,xyz,2048-05-11
4667,1047,3620,2019,5,12,xyz,2048-05-12
1648,5828,-4180,2019,5,13,xyz,2048-05-13
4315,6904,-2589,2019,5,14,xyz,2048-05-14
9671,9188,483,2019,5,15,xyz,2048-05-15
8095,7534,561,2019,5,16,xyz,2048-05-16
1139,1326,-187,2019,5,17,xyz,2048-05-17
5676,3821,1855,2019,5,18,xyz,2048-05-18
2582,7065,-4483,2019,5,19,xyz,2048-05-19
5892,2798,3094,2019,5,20,xyz,2048-05-20
3320,7722,-4402,2019,5,21,xyz,2048-05-21
2439,1880,559,2019,5,22,xyz,2048-05-22
7656,9018,-1362,2019,5,23,xyz,2048-05-23
8376,9954,-1578,2019,5,24,xyz,2048-05-24
5294,7291,-1997,2019,5,25,xyz,2048-05-25
1067,2965,-1898,2019,5,26,xyz,2048-05-26
7704,1866,5838,2019,5,27,xyz,2048-05-27
3864,1631,2233,2019,5,28,xyz,2048-05-28
8968,6941,2027,2019,5,29,xyz,2048-05-29
8801,7984,817,2019,5,30,xyz,2048-05-30
1954,5887,-3933,2019,5,31,xyz,2048-05-31
6789,1651,5138,2019,6,1,xyz,2048-06-01
5619,8697,-3078,2019,6,2,xyz,2048-06-02
4469,9376,-4907,2019,6,3,xyz,2048-06-03
7057,2899,4158,2019,6,4,xyz,2048-06-04
1107,1482,-375,2019,6,5,xyz,2048-06-05
8083,4527,3556,2019,6,6,xyz,2048-06-06
2798,2298,500,2019,6,7,xyz,2048-06-07
5532,7198,-1666,2019,6,8,xyz,2048-06-08
7497,3716,3781,2019,6,9,xyz,2048-06-09
8953,3988,4965,2019,6,10,xyz,2048-06-10
5821,4785,1036,2019,6,11,xyz,2048-06-11
6422,4158,2264,2019,6,12,xyz,2048-06-12
5620,784,4836,2019,6,13,xyz,2048-06-13
8194,9762,-1568,2019,6,14,xyz,2048-06-14
1189,3967,-2778,2019,6,15,xyz,2048-06-15
1931,1320,611,2019,6,16,xyz,2048-06-16
8951,1346,7605,2019,6,17,xyz,2048-06-17
2605,5079,-2474,2019,6,18,xyz,2048-06-18
3523,1476,2047,2019,6,19,xyz,2048-06-19
4735,9384,-4649,2019,6,20,xyz,2048-06-20
1453,6351,-4898,2019,6,21,xyz,2048-06-21
4708,6834,-2126,2019,6,22,xyz,2048-06-22
7466,9867,-2401,2019,6,23,xyz,2048-06-23
7238,9820,-2582,2019,6,24,xyz,2048-06-24
3329,1110,2219,2019,6,25,xyz,2048-06-25
1812,5411,-3599,2019,6,26,xyz,2048-06-26
1611,6846,-5235,2019,6,27,xyz,2048-06-27
4868,8646,-3778,2019,6,28,xyz,2048-06-28
5338,704,4634,2019,6,29,xyz,2048-06-29
3063,9418,-6355,2019,6,30,xyz,2048-06-30
7764,5524,2240,2019,7,1,xyz,2048-07-01
3836,5739,-1903,2019,7,2,xyz,2048-07-02
8842,7868,974,2019,7,3,xyz,2048-07-03
1745,3579,-1834,2019,7,4,xyz,2048-07-04
3442,5827,-2385,2019,7,5,xyz,2048-07-05
6291,6743,-452,2019,7,6,xyz,2048-07-06
9096,732,8364,2019,7,7,xyz,2048-07-07
5869,7236,-1367,2019,7,8,xyz,2048-07-08
3909,1515,2394,2019,7,9,xyz,2048-07-09
8164,2170,5994,2019,7,10,xyz,2048-07-10
3237,8382,-5145,2019,7,11,xyz,2048-07-11
4538,6051,-1513,2019,7,12,xyz,2048-07-12
9604,4746,4858,2019,7,13,xyz,2048-07-13
5613,7529,-1916,2019,7,14,xyz,2048-07-14
5422,7349,-1927,2019,7,15,xyz,2048-07-15
2799,7987,-5188,2019,7,16,xyz,2048-07-16
5465,1782,3683,2019,7,17,xyz,2048-07-17
6887,7105,-218,2019,7,18,xyz,2048-07-18
1079,4650,-3571,2019,7,19,xyz,2048-07-19
2881,1468,1413,2019,7,20,xyz,2048-07-20
9555,2398,7157,2019,7,21,xyz,2048-07-21
5146,3174,1972,2019,7,22,xyz,2048-07-22
7651,1562,6089,2019,7,23,xyz,2048-07-23
2220,2711,-491,2019,7,24,xyz,2048-07-24
5578,5698,-120,2019,7,25,xyz,2048-07-25
3493,1743,1750,2019,7,26,xyz,2048-07-26
8736,2988,5748,2019,7,27,xyz,2048-07-27
6152,9596,-3444,2019,7,28,xyz,2048-07-28
7067,5048,2019,2019,7,29,xyz,2048-07-29
9974,4598,5376,2019,7,30,xyz,2048-07-30
3597,9545,-5948,2019,7,31,xyz,2048-07-31
3319,8990,-5671,2019,8,1,xyz,2048-08-01
5214,5620,-406,2019,8,2,xyz,2048-08-02
5059,3643,1416,2019,8,3,xyz,2048-08-03
9969,8173,1796,2019,8,4,xyz,2048-08-04
8228,7852,376,2019,8,5,xyz,2048-08-05
5525,9509,-3984,2019,8,6,xyz,2048-08-06
2654,7307,-4653,2019,8,7,xyz,2048-08-07
8494,9007,-513,2019,8,8,xyz,2048-08-08
5547,4278,1269,2019,8,9,xyz,2048-08-09
4156,5454,-1298,2019,8,10,xyz,2048-08-10
1222,4069,-2847,2019,8,11,xyz,2048-08-11
8184,4293,3891,2019,8,12,xyz,2048-08-12
7678,5320,2358,2019,8,13,xyz,2048-08-13
1636,5145,-3509,2019,8,14,xyz,2048-08-14
5737,8638,-2901,2019,8,15,xyz,2048-08-15
2686,6858,-4172,2019,8,16,xyz,2048-08-16
2862,1164,1698,2019,8,17,xyz,2048-08-17
5617,2513,3104,2019,8,18,xyz,2048-08-18
3546,1230,2316,2019,8,19,xyz,2048-08-19
2797,7740,-4943,2019,8,20,xyz,2048-08-20
5721,5928,-207,2019,8,21,xyz,2048-08-21
8050,4911,3139,2019,8,22,xyz,2048-08-22
6982,6574,408,2019,8,23,xyz,2048-08-23
7670,5971,1699,2019,8,24,xyz,2048-08-24
2245,6348,-4103,2019,8,25,xyz,2048-08-25
7661,4461,3200,2019,8,26,xyz,2048-08-26
7117,2324,4793,2019,8,27,xyz,2048-08-27
7012,3204,3808,2019,8,28,xyz,2048-08-28
6070,648,5422,2019,8,29,xyz,2048-08-29
2346,9873,-7527,2019,8,30,xyz,2048-08-30
4682,1774,2908,2019,8,31,xyz,2048-08-31
3703,3634,69,2019,9,1,xyz,2048-09-01
8459,1399,7060,2019,9,2,xyz,2048-09-02
8982,8624,358,2019,9,3,xyz,2048-09-03
7084,6987,97,2019,9,4,xyz,2048-09-04
6741,698,6043,2019,9,5,xyz,2048-09-05
8666,2833,5833,2019,9,6,xyz,2048-09-06
2346,5493,-3147,2019,9,7,xyz,2048-09-07
1466,8052,-6586,2019,9,8,xyz,2048-09-08
8496,6543,1953,2019,9,9,xyz,2048-09-09
3590,5890,-2300,2019,9,10,xyz,2048-09-10
9509,7981,1528,2019,9,11,xyz,2048-09-11
3151,7237,-4086,2019,9,12,xyz,2048-09-12
1671,7067,-5396,2019,9,13,xyz,2048-09-13
1902,918,984,2019,9,14,xyz,2048-09-14
5490,1179,4311,2019,9,15,xyz,2048-09-15
8696,2162,6534,2019,9,16,xyz,2048-09-16
5434,5579,-145,2019,9,17,xyz,2048-09-17
3939,1164,2775,2019,9,18,xyz,2048-09-18
6863,6340,523,2019,9,19,xyz,2048-09-19
6929,878,6051,2019,9,20,xyz,2048-09-20
5689,6883,-1194,2019,9,21,xyz,2048-09-21
9017,9206,-189,2019,9,22,xyz,2048-09-22
2995,706,2289,2019,9,23,xyz,2048-09-23
8948,1511,7437,2019,9,24,xyz,2048-09-24
1827,622,1205,2019,9,25,xyz,2048-09-25
2068,4055,-1987,2019,9,26,xyz,2048-09-26
6313,1155,5158,2019,9,27,xyz,2048-09-27
5812,6263,-451,2019,9,28,xyz,2048-09-28
6726,6672,54,2019,9,29,xyz,2048-09-29
7279,3856,3423,2019,9,30,xyz,2048-09-30
3618,8217,-4599,2019,10,1,xyz,2048-10-01
3832,7547,-3715,2019,10,2,xyz,2048-10-02
2520,807,1713,2019,10,3,xyz,2048-10-03
8464,5314,3150,2019,10,4,xyz,2048-10-04
4539,6445,-1906,2019,10,5,xyz,2048-10-05
8138,6341,1797,2019,10,6,xyz,2048-10-06
9221,6658,2563,2019,10,7,xyz,2048-10-07
6609,828,5781,2019,10,8,xyz,2048-10-08
4547,2431,2116,2019,10,9,xyz,2048-10-09
4297,9592,-5295,2019,10,10,xyz,2048-10-10
9393,8213,1180,2019,10,11,xyz,2048-10-11
2199,9278,-7079,2019,10,12,xyz,2048-10-12
5826,7970,-2144,2019,10,13,xyz,2048-10-13
8135,693,7442,2019,10,14,xyz,2048-10-14
7792,8936,-1144,2019,10,15,xyz,2048-10-15
5110,5729,-619,2019,10,16,xyz,2048-10-16
1296,4943,-3647,2019,10,17,xyz,2048-10-17
2714,8946,-6232,2019,10,18,xyz,2048-10-18
4248,8064,-3816,2019,10,19,xyz,2048-10-19
3347,8828,-5481,2019,10,20,xyz,2048-10-20
1549,591,958,2019,10,21,xyz,2048-10-21
1012,6617,-5605,2019,10,22,xyz,2048-10-22
9575,1686,7889,2019,10,23,xyz,2048-10-23
6135,7731,-1596,2019,10,24,xyz,2048-10-24
6365,8264,-1899,2019,10,25,xyz,2048-10-25
7698,1637,6061,2019,10,26,xyz,2048-10-26
6360,4250,2110,2019,10,27,xyz,2048-10-27
8577,3501,5076,2019,10,28,xyz,2048-10-28
7022,9385,-2363,2019,10,29,xyz,2048-10-29
4260,4361,-101,2019,10,30,xyz,2048-10-30
4806,7677,-2871,2019,10,31,xyz,2048-10-31
1062,4776,-3714,2019,11,1,xyz,2048-11-01
2858,4525,-1667,2019,11,2,xyz,2048-11-02
7087,4886,2201,2019,11,3,xyz,2048-11-03
8324,9028,-704,2019,11,4,xyz,2048-11-04
8805,4995,3810,2019,11,5,xyz,2048-11-05
2310,7290,-4980,2019,11,6,xyz,2048-11-06
4431,4039,392,2019,11,7,xyz,2048-11-07
3845,2025,1820,2019,11,8,xyz,2048-11-08
5640,7569,-1929,2019,11,9,xyz,2048-11-09
9201,5556,3645,2019,11,10,xyz,2048-11-10
3469,6581,-3112,2019,11,11,xyz,2048-11-11
2888,2667,221,2019,11,12,xyz,2048-11-12
8906,8119,787,2019,11,13,xyz,2048-11-13
7936,8104,-168,2019,11,14,xyz,2048-11-14
5862,2338,3524,2019,11,15,xyz,2048-11-15
3201,1760,1441,2019,11,16,xyz,2048-11-16
3322,6878,-3556,2019,11,17,xyz,2048-11-17
4184,4316,-132,2019,11,18,xyz,2048-11-18
5514,2802,2712,2019,11,19,xyz,2048-11-19
4166,8769,-4603,2019,11,20,xyz,2048-11-20
6547,3090,3457,2019,11,21,xyz,2048-11-21
2836,2166,670,2019,11,22,xyz,2048-11-22
2645,9422,-6777,2019,11,23,xyz,2048-11-23
3910,4162,-252,2019,11,24,xyz,2048-11-24
9129,9871,-742,2019,11,25,xyz,2048-11-25
6097,2333,3764,2019,11,26,xyz,2048-11-26
4562,1161,3401,2019,11,27,xyz,2048-11-27
9706,7233,2473,2019,11,28,xyz,2048-11-28
2038,1910,128,2019,11,29,xyz,2048-11-29
6650,760,5890,2019,11,30,xyz,2048-11-30
6690,3398,3292,2019,12,1,xyz,2048-12-01
3699,2732,967,2019,12,2,xyz,2048-12-02
7302,5421,1881,2019,12,3,xyz,2048-12-03
9699,7772,1927,2019,12,4,xyz,2048-12-04
6547,3526,3021,2019,12,5,xyz,2048-12-05
8886,2217,6669,2019,12,6,xyz,2048-12-06
3168,7341,-4173,2019,12,7,xyz,2048-12-07
8032,8729,-697,2019,12,8,xyz,2048-12-08
9930,6303,3627,2019,12,9,xyz,2048-12-09
4559,6664,-2105,2019,12,10,xyz,2048-12-10
4202,1473,2729,2019,12,11,xyz,2048-12-11
8071,3281,4790,2019,12,12,xyz,2048-12-12
7683,1424,6259,2019,12,13,xyz,2048-12-13
5716,2834,2882,2019,12,14,xyz,2048-12-14
3292,4992,-1700,2019,12,15,xyz,2048-12-15
9383,1249,8134,2019,12,16,xyz,2048-12-16
7851,4068,3783,2019,12,17,xyz,2048-12-17
5972,7491,-1519,2019,12,18,xyz,2048-12-18
3688,1481,2207,2019,12,19,xyz,2048-12-19
1390,6527,-5137,2019,12,20,xyz,2048-12-20
7521,6445,1076,2019,12,21,xyz,2048-12-21
5073,3269,1804,2019,12,22,xyz,2048-12-22
4857,3657,1200,2019,12,23,xyz,2048-12-23
9703,3917,5786,2019,12,24,xyz,2048-12-24
8104,2794,5310,2019,12,25,xyz,2048-12-25
8471,2708,5763,2019,12,26,xyz,2048-12-26
3312,4072,-760,2019,12,27,xyz,2048-12-27
9781,7656,2125,2019,12,28,xyz,2048-12-28
7703,7203,500,2019,12,29,xyz,2048-12-29
7517,4651,2866,2019,12,30,xyz,2048-12-30
8461,6165,2296,2019,12,31,xyz,2048-12-31
2191,3041,-850,2020,1,1,xyz,2049-01-01
3719,4052,-333,2020,1,2,xyz,2049-01-02
5493,6528,-1035,2020,1,3,xyz,2049-01-03
4186,3207,979,2020,1,4,xyz,2049-01-04
5443,7601,-2158,2020,1,5,xyz,2049-01-05
7099,1304,5795,2020,1,6,xyz,2049-01-06
2783,7144,-4361,2020,1,7,xyz,2049-01-07
9147,1029,8118,2020,1,8,xyz,2049-01-08
5885,3730,2155,2020,1,9,xyz,2049-01-09
6846,5810,1036,2020,1,10,xyz,2049-01-10
6624,6799,-175,2020,1,11,xyz,2049-01-11
8627,7378,1249,2020,1,12,xyz,2049-01-12
1136,6552,-5416,2020,1,13,xyz,2049-01-13
2319,784,1535,2020,1,14,xyz,2049-01-14
6309,3395,2914,2020,1,15,xyz,2049-01-15
9715,1181,8534,2020,1,16,xyz,2049-01-16
4606,8759,-4153,2020,1,17,xyz,2049-01-17
5997,2697,3300,2020,1,18,xyz,2049-01-18
9457,4604,4853,2020,1,19,xyz,2049-01-19
9512,5668,3844,2020,1,20,xyz,2049-01-20
3403,3525,-122,2020,1,21,xyz,2049-01-21
1071,1486,-415,2020,1,22,xyz,2049-01-22
9802,3848,5954,2020,1,23,xyz,2049-01-23
9597,5419,4178,2020,1,24,xyz,2049-01-24
8069,4272,3797,2020,1,25,xyz,2049-01-25
6866,8828,-1962,2020,1,26,xyz,2049-01-26
8399,2995,5404,2020,1,27,xyz,2049-01-27
4980,1820,3160,2020,1,28,xyz,2049-01-28
5560,4959,601,2020,1,29,xyz,2049-01-29
3766,4577,-811,2020,1,30,xyz,2049-01-30
7484,1943,5541,2020,1,31,xyz,2049-01-31
2971,6637,-3666,2020,2,1,xyz,2049-02-01
6030,8587,-2557,2020,2,2,xyz,2049-02-02
3730,2534,1196,2020,2,3,xyz,2049-02-03
9411,1166,8245,2020,2,4,xyz,2049-02-04
4860,7558,-2698,2020,2,5,xyz,2049-02-05
2999,3715,-716,2020,2,6,xyz,2049-02-06
7058,8217,-1159,2020,2,7,xyz,2049-02-07
6693,8391,-1698,2020,2,8,xyz,2049-02-08
5057,9583,-4526,2020,2,9,xyz,2049-02-09
5226,8125,-2899,2020,2,10,xyz,2049-02-10
1485,6322,-4837,2020,2,11,xyz,2049-02-11
6564,6278,286,2020,2,12,xyz,2049-02-12
7856,2127,5729,2020,2,13,xyz,2049-02-13
5479,8103,-2624,2020,2,14,xyz,2049-02-14
9788,2589,7199,2020,2,15,xyz,2049-02-15
7063,4302,2761,2020,2,16,xyz,2049-02-16
9121,4114,5007,2020,2,17,xyz,2049-02-17
6122,8014,-1892,2020,2,18,xyz,2049-02-18
3374,4669,-1295,2020,2,19,xyz,2049-02-19
6152,8037,-1885,2020,2,20,xyz,2049-02-20
7739,7427,312,2020,2,21,xyz,2049-02-21
4647,4015,632,2020,2,22,xyz,2049-02-22
6998,4512,2486,2020,2,23,xyz,2049-02-23
2524,4575,-2051,2020,2,24,xyz,2049-02-24
6592,5281,1311,2020,2,25,xyz,2049-02-25
1090,1872,-782,2020,2,26,xyz,2049-02-26
2121,5676,-3555,2020,2,27,xyz,2049-02-27
6655,9028,-2373,2020,2,28,xyz,2049-02-28
5169,4139,1030,2020,3,1,xyz,2049-03-01
7227,5047,2180,2020,3,2,xyz,2049-03-02
6572,7340,-768,2020,3,3,xyz,2049-03-03
3871,1884,1987,2020,3,4,xyz,2049-03-04
1042,3036,-1994,2020,3,5,xyz,2049-03-05
6692,6854,-162,2020,3,6,xyz,2049-03-06
7073,8318,-1245,2020,3,7,xyz,2049-03-07
1338,1252,86,2020,3,8,xyz,2049-03-08
5259,4756,503,2020,3,9,xyz,2049-03-09
9371,7600,1771,2020,3,10,xyz,2049-03-10
8550,7929,621,2020,3,11,xyz,2049-03-11
1931,8788,-6857,2020,3,12,xyz,2049-03-12
3954,8273,-4319,2020,3,13,xyz,2049-03-13
2238,2171,67,2020,3,14,xyz,2049-03-14
1606,3757,-2151,2020,3,15,xyz,2049-03-15
8191,6768,1423,2020,3,16,xyz,2049-03-16
4518,5676,-1158,2020,3,17,xyz,2049-03-17
2332,8195,-5863,2020,3,18,xyz,2049-03-18
7680,7826,-146,2020,3,19,xyz,2049-03-19
7280,3067,4213,2020,3,20,xyz,2049-03-20
5764,1401,4363,2020,3,21,xyz,2049-03-21
5476,3861,1615,2020,3,22,xyz,2049-03-22
6055,4133,1922,2020,3,23,xyz,2049-03-23
3809,1359,2450,2020,3,24,xyz,2049-03-24
7001,4318,2683,2020,3,25,xyz,2049-03-25
4289,5962,-1673,2020,3,26,xyz,2049-03-26
1498,9262,-7764,2020,3,27,xyz,2049-03-27
4905,1625,3280,2020,3,28,xyz,2049-03-28
9613,7013,2600,2020,3,29,xyz,2049-03-29
9710,929,8781,2020,3,30,xyz,2049-03-30
6951,6322,629,2020,3,31,xyz,2049-03-31
2293,7520,-5227,2020,4,1,xyz,2049-04-01
9306,9631,-325,2020,4,2,xyz,2049-04-02
5530,5276,254,2020,4,3,xyz,2049-04-03
5491,3602,1889,2020,4,4,xyz,2049-04-04
9323,5839,3484,2020,4,5,xyz,2049-04-05
4611,6276,-1665,2020,4,6,xyz,2049-04-06
3010,7576,-4566,2020,4,7,xyz,2049-04-07
1960,4111,-2151,2020,4,8,xyz,2049-04-08
3020,1238,1782,2020,4,9,xyz,2049-04-09
2388,1753,635,2020,4,10,xyz,2049-04-10
6862,5710,1152,2020,4,11,xyz,2049-04-11
9273,4231,5042,2020,4,12,xyz,2049-04-12
4086,7710,-3624,2020,4,13,xyz,2049-04-13
9129,7893,1236,2020,4,14,xyz,2049-04-14
8493,836,7657,2020,4,15,xyz,2049-04-15
1816,2453,-637,2020,4,16,xyz,2049-04-16
8601,6253,2348,2020,4,17,xyz,2049-04-17
3711,9065,-5354,2020,4,18,xyz,2049-04-18
2191,5548,-3357,2020,4,19,xyz,2049-04-19
7970,4276,3694,2020,4,20,xyz,2049-04-20
8037,8891,-854,2020,4,21,xyz,2049-04-21
5350,2217,3133,2020,4,22,xyz,2049-04-22
8669,3822,4847,2020,4,23,xyz,2049-04-23
3467,3195,272,2020,4,24,xyz,2049-04-24
9731,911,8820,2020,4,25,xyz,2049-04-25
6793,4593,2200,2020,4,26,xyz,2049-04-26
7662,3867,3795,2020,4,27,xyz,2049-04-27
6861,7605,-744,2020,4,28,xyz,2049-04-28
9131,6283,2848,2020,4,29,xyz,2049-04-29
8957,4190,4767,2020,4,30,xyz,2049-04-30
7749,6294,1455,2020,5,1,xyz,2049-05-01
2749,5518,-2769,2020,5,2,xyz,2049-05-02
2096,8720,-6624,2020,5,3,xyz,2049-05-03
7672,9322,-1650,2020,5,4,xyz,2049-05-04
8114,7363,751,2020,5,5,xyz,2049-05-05
9008,6147,2861,2020,5,6,xyz,2049-05-06
7047,4572,2475,2020,5,7,xyz,2049-05-07
7537,1226,6311,2020,5,8,xyz,2049-05-08
4763,3626,1137,2020,5,9,xyz,2049-05-09
6200,8939,-2739,2020,5,10,xyz,2049-05-10
2401,2815,-414,2020,5,11,xyz,2049-05-11
2165,7438,-5273,2020,5,12,xyz,2049-05-12
7900,9555,-1655,2020,5,13,xyz,2049-05-13
8823,4639,4184,2020,5,14,xyz,2049-05-14
6537,3081,3456,2020,5,15,xyz,2049-05-15
9472,2300,7172,2020,5,16,xyz,2049-05-16
7082,9220,-2138,2020,5,17,xyz,2049-05-17
5970,8301,-2331,2020,5,18,xyz,2049-05-18
9391,3131,6260,2020,5,19,xyz,2049-05-19
8995,9041,-46,2020,5,20,xyz,2049-05-20
2836,4317,-1481,2020,5,21,xyz,2049-05-21
9343,6959,2384,2020,5,22,xyz,2049-05-22
8700,2270,6430,2020,5,23,xyz,2049-05-23
9345,8212,1133,2020,5,24,xyz,2049-05-24
6982,2092,4890,2020,5,25,xyz,2049-05-25
1718,8355,-6637,2020,5,26,xyz,2049-05-26
3019,3780,-761,2020,5,27,xyz,2049-05-27
8149,5819,2330,2020,5,28,xyz,2049-05-28
3874,5477,-1603,2020,5,29,xyz,2049-05-29
7429,7553,-124,2020,5,30,xyz,2049-05-30
3719,6876,-3157,2020,5,31,xyz,2049-05-31
9890,4317,5573,2020,6,1,xyz,2049-06-01
8152,4280,3872,2020,6,2,xyz,2049-06-02
8370,9518,-1148,2020,6,3,xyz,2049-06-03
4435,8595,-4160,2020,6,4,xyz,2049-06-04
5606,7545,-1939,2020,6,5,xyz,2049-06-05
3030,9099,-6069,2020,6,6,xyz,2049-06-06
4496,3360,1136,2020,6,7,xyz,2049-06-07
1891,946,945,2020,6,8,xyz,2049-06-08
4421,6154,-1733,2020,6,9,xyz,2049-06-09
9133,2454,6679,2020,6,10,xyz,2049-06-10
2325,978,1347,2020,6,11,xyz,2049-06-11
4525,4001,524,2020,6,12,xyz,2049-06-12
2857,3773,-916,2020,6,13,xyz,2049-06-13
9788,8161,1627,2020,6,14,xyz,2049-06-14
7333,2734,4599,2020,6,15,xyz,2049-06-15
4385,6721,-2336,2020,6,16,xyz,2049-06-16
5375,7188,-1813,2020,6,17,xyz,2049-06-17
1184,6804,-5620,2020,6,18,xyz,2049-06-18
4051,3728,323,2020,6,19,xyz,2049-06-19
5782,2926,2856,2020,6,20,xyz,2049-06-20
3310,7525,-4215,2020,6,21,xyz,2049-06-21
4214,6339,-2125,2020,6,22,xyz,2049-06-22
5210,686,4524,2020,6,23,xyz,2049-06-23
7994,4398,3596,2020,6,24,xyz,2049-06-24
7118,1339,5779,2020,6,25,xyz,2049-06-25
1425,690,735,2020,6,26,xyz,2049-06-26
5933,7316,-1383,2020,6,27,xyz,2049-06-27
6652,6584,68,2020,6,28,xyz,2049-06-28
5632,3486,2146,2020,6,29,xyz,2049-06-29
5342,2108,3234,2020,6,30,xyz,2049-06-30
6449,1828,4621,2020,7,1,xyz,2049-07-01
8503,9837,-1334,2020,7,2,xyz,2049-07-02
7941,2515,5426,2020,7,3,xyz,2049-07-03
3098,6211,-3113,2020,7,4,xyz,2049-07-04
3633,9400,-5767,2020,7,5,xyz,2049-07-05
3932,3692,240,2020,7,6,xyz,2049-07-06
3741,2862,879,2020,7,7,xyz,2049-07-07
4416,6309,-1893,2020,7,8,xyz,2049-07-08
1798,9817,-8019,2020,7,9,xyz,2049-07-09
1888,8279,-6391,2020,7,10,xyz,2049-07-10
7399,3491,3908,2020,7,11,xyz,2049-07-11
4250,9342,-5092,2020,7,12,xyz,2049-07-12
6502,6584,-82,2020,7,13,xyz,2049-07-13
4454,982,3472,2020,7,14,xyz,2049-07-14
5063,4033,1030,2020,7,15,xyz,2049-07-15
6444,1344,5100,2020,7,16,xyz,2049-07-16
4431,6438,-2007,2020,7,17,xyz,2049-07-17
2551,2288,263,2020,7,18,xyz,2049-07-18
8703,9422,-719,2020,7,19,xyz,2049-07-19
9228,4874,4354,2020,7,20,xyz,2049-07-20
3627,6808,-3181,2020,7,21,xyz,2049-07-21
9267,7502,1765,2020,7,22,xyz,2049-07-22
1141,4071,-2930,2020,7,23,xyz,2049-07-23
5308,7423,-2115,2020,7,24,xyz,2049-07-24
3781,5775,-1994,2020,7,25,xyz,2049-07-25
5093,8001,-2908,2020,7,26,xyz,2049-07-26
1082,9340,-8258,2020,7,27,xyz,2049-07-27
4759,6835,-2076,2020,7,28,xyz,2049-07-28
8805,1297,7508,2020,7,29,xyz,2049-07-29
6748,1131,5617,2020,7,30,xyz,2049-07-30
7264,2285,4979,2020,7,31,xyz,2049-07-31
1230,1366,-136,2020,8,1,xyz,2049-08-01
5004,4808,196,2020,8,2,xyz,2049-08-02
6645,5886,759,2020,8,3,xyz,2049-08-03
2933,4044,-1111,2020,8,4,xyz,2049-08-04
8152,5191,2961,2020,8,5,xyz,2049-08-05
9556,4758,4798,2020,8,6,xyz,2049-08-06
3719,3586,133,2020,8,7,xyz,2049-08-07
2686,5999,-3313,2020,8,8,xyz,2049-08-08
9725,8737,988,2020,8,9,xyz,2049-08-09
1862,7657,-5795,2020,8,10,xyz,2049-08-10
7003,2267,4736,2020,8,11,xyz,2049-08-11
6002,6847,-845,2020,8,12,xyz,2049-08-12
7123,3061,4062,2020,8,13,xyz,2049-08-13
7574,6182,1392,2020,8,14,xyz,2049-08-14
3143,2852,291,2020,8,15,xyz,2049-08-15
9631,2382,7249,2020,8,16,xyz,2049-08-16
6826,1176,5650,2020,8,17,xyz,2049-08-17
6250,649,5601,2020,8,18,xyz,2049-08-18
1834,1474,360,2020,8,19,xyz,2049-08-19
2268,2229,39,2020,8,20,xyz,2049-08-20
4454,1584,2870,2020,8,21,xyz,2049-08-21
3906,9351,-5445,2020,8,22,xyz,2049-08-22
6625,7629,-1004,2020,8,23,xyz,2049-08-23
8499,5252,3247,2020,8,24,xyz,2049-08-24
4636,3409,1227,2020,8,25,xyz,2049-08-25
2616,1220,1396,2020,8,26,xyz,2049-08-26
9874,2193,7681,2020,8,27,xyz,2049-08-27
3587,3991,-404,2020,8,28,xyz,2049-08-28
2674,5888,-3214,2020,8,29,xyz,2049-08-29
3113,3149,-36,2020,8,30,xyz,2049-08-30
1916,3331,-1415,2020,8,31,xyz,2049-08-31
9050,1085,7965,2020,9,1,xyz,2049-09-01
4649,4837,-188,2020,9,2,xyz,2049-09-02
5598,6663,-1065,2020,9,3,xyz,2049-09-03
2116,7104,-4988,2020,9,4,xyz,2049-09-04
1524,9473,-7949,2020,9,5,xyz,2049-09-05
4911,1800,3111,2020,9,6,xyz,2049-09-06
8954,6489,2465,2020,9,7,xyz,2049-09-07
4974,7429,-2455,2020,9,8,xyz,2049-09-08
7058,8673,-1615,2020,9,9,xyz,2049-09-09
4265,6243,-1978,2020,9,10,xyz,2049-09-10
1277,1186,91,2020,9,11,xyz,2049-09-11
6040,8180,-2140,2020,9,12,xyz,2049-09-12
1810,3187,-1377,2020,9,13,xyz,2049-09-13
3892,5438,-1546,2020,9,14,xyz,2049-09-14
3431,3964,-533,2020,9,15,xyz,2049-09-15
4072,5687,-1615,2020,9,16,xyz,2049-09-16
4186,3127,1059,2020,9,17,xyz,2049-09-17
1719,7832,-6113,2020,9,18,xyz,2049-09-18
7661,4317,3344,2020,9,19,xyz,2049-09-19
2048,1729,319,2020,9,20,xyz,2049-09-20
5577,3712,1865,2020,9,21,xyz,2049-09-21
3076,3507,-431,2020,9,22,xyz,2049-09-22
5997,960,5037,2020,9,23,xyz,2049-09-23
3442,1946,1496,2020,9,24,xyz,2049-09-24
7293,6891,402,2020,9,25,xyz,2049-09-25
1171,3091,-1920,2020,9,26,xyz,2049-09-26
7668,3871,3797,2020,9,27,xyz,2049-09-27
7305,3843,3462,2020,9,28,xyz,2049-09-28
6838,8440,-1602,2020,9,29,xyz,2049-09-29
4698,5179,-481,2020,9,30,xyz,2049-09-30
1205,5796,-4591,2020,10,1,xyz,2049-10-01
3164,9792,-6628,2020,10,2,xyz,2049-10-02
7219,4338,2881,2020,10,3,xyz,2049-10-03
3014,8066,-5052,2020,10,4,xyz,2049-10-04
5090,2588,2502,2020,10,5,xyz,2049-10-05
6436,613,5823,2020,10,6,xyz,2049-10-06
9755,7595,2160,2020,10,7,xyz,2049-10-07
6786,7762,-976,2020,10,8,xyz,2049-10-08
4512,9244,-4732,2020,10,9,xyz,2049-10-09
5401,4204,1197,2020,10,10,xyz,2049-10-10
6315,2057,4258,2020,10,11,xyz,2049-10-11
9339,7177,2162,2020,10,12,xyz,2049-10-12
3638,2024,1614,2020,10,13,xyz,2049-10-13
2236,6923,-4687,2020,10,14,xyz,2049-10-14
6893,3125,3768,2020,10,15,xyz,2049-10-15
5751,5775,-24,2020,10,16,xyz,2049-10-16
8837,8402,435,2020,10,17,xyz,2049-10-17
9878,6432,3446,2020,10,18,xyz,2049-10-18
4507,7198,-2691,2020,10,19,xyz,2049-10-19
9131,4924,4207,2020,10,20,xyz,2049-10-20
6718,7878,-1160,2020,10,21,xyz,2049-10-21
4433,7793,-3360,2020,10,22,xyz,2049-10-22
7777,6222,1555,2020,10,23,xyz,2049-10-23
2154,4654,-2500,2020,10,24,xyz,2049-10-24
4834,3786,1048,2020,10,25,xyz,2049-10-25
8917,4363,4554,2020,10,26,xyz,2049-10-26
2635,6503,-3868,2020,10,27,xyz,2049-10-27
9429,7412,2017,2020,10,28,xyz,2049-10-28
8889,9019,-130,2020,10,29,xyz,2049-10-29
2577,4970,-2393,2020,10,30,xyz,2049-10-30
7919,9849,-1930,2020,10,31,xyz,2049-10-31
6547,1673,4874,2020,11,1,xyz,2049-11-01
4300,6804,-2504,2020,11,2,xyz,2049-11-02
9341,5098,4243,2020,11,3,xyz,2049-11-03
5846,7679,-1833,2020,11,4,xyz,2049-11-04
7232,6344,888,2020,11,5,xyz,2049-11-05
2256,7598,-5342,2020,11,6,xyz,2049-11-06
2019,4611,-2592,2020,11,7,xyz,2049-11-07
6712,8641,-1929,2020,11,8,xyz,2049-11-08
8477,4105,4372,2020,11,9,xyz,2049-11-09
4082,4959,-877,2020,11,10,xyz,2049-11-10
9564,7953,1611,2020,11,11,xyz,2049-11-11
4677,6600,-1923,2020,11,12,xyz,2049-11-12
4657,4419,238,2020,11,13,xyz,2049-11-13
7745,2912,4833,2020,11,14,xyz,2049-11-14
4261,5952,-1691,2020,11,15,xyz,2049-11-15
5891,8529,-2638,2020,11,16,xyz,2049-11-16
4362,6982,-2620,2020,11,17,xyz,2049-11-17
4895,5465,-570,2020,11,18,xyz,2049-11-18
1326,4595,-3269,2020,11,19,xyz,2049-11-19
7112,5980,1132,2020,11,20,xyz,2049-11-20
1326,1007,319,2020,11,21,xyz,2049-11-21
6679,8419,-1740,2020,11,22,xyz,2049-11-22
8647,4601,4046,2020,11,23,xyz,2049-11-23
7936,9628,-1692,2020,11,24,xyz,2049-11-24
5776,7392,-1616,2020,11,25,xyz,2049-11-25
6742,6924,-182,2020,11,26,xyz,2049-11-26
8395,7237,1158,2020,11,27,xyz,2049-11-27
8205,670,7535,2020,11,28,xyz,2049-11-28
5825,6301,-476,2020,11,29,xyz,2049-11-29
7194,1631,5563,2020,11,30,xyz,2049-11-30
5528,6842,-1314,2020,12,1,xyz,2049-12-01
7880,5751,2129,2020,12,2,xyz,2049-12-02
4141,4469,-328,2020,12,3,xyz,2049-12-03
3096,4737,-1641,2020,12,4,xyz,2049-12-04
8411,1912,6499,2020,12,5,xyz,2049-12-05
8671,4875,3796,2020,12,6,xyz,2049-12-06
9094,8951,143,2020,12,7,xyz,2049-12-07
4553,5907,-1354,2020,12,8,xyz,2049-12-08
2112,519,1593,2020,12,9,xyz,2049-12-09
9190,6755,2435,2020,12,10,xyz,2049-12-10
4549,3920,629,2020,12,11,xyz,2049-12-11
2994,8903,-5909,2020,12,12,xyz,2049-12-12
2619,8360,-5741,2020,12,13,xyz,2049-12-13
4618,3855,763,2020,12,14,xyz,2049-12-14
2309,9402,-7093,2020,12,15,xyz,2049-12-15
9838,5798,4040,2020,12,16,xyz,2049-12-16
5979,5589,390,2020,12,17,xyz,2049-12-17
9788,4054,5734,2020,12,18,xyz,2049-12-18
8478,8896,-418,2020,12,19,xyz,2049-12-19
9791,721,9070,2020,12,20,xyz,2049-12-20
4919,5624,-705,2020,12,21,xyz,2049-12-21
8604,2767,5837,2020,12,22,xyz,2049-12-22
9156,1515,7641,2020,12,23,xyz,2049-12-23
2015,8016,-6001,2020,12,24,xyz,2049-12-24
7534,9153,-1619,2020,12,25,xyz,2049-12-25
7990,7222,768,2020,12,26,xyz,2049-12-26
1769,1899,-130,2020,12,27,xyz,2049-12-27
5988,7016,-1028,2020,12,28,xyz,2049-12-28
4413,4360,53,2020,12,29,xyz,2049-12-29
7313,8275,-962,2020,12,30,xyz,2049-12-30
4900,7229,-2329,2020,12,31,xyz,2049-12-31
2687,2881,-194,2021,1,1,xyz,2050-01-01
6150,2378,3772,2021,1,2,xyz,2050-01-02
6151,5466,685,2021,1,3,xyz,2050-01-03
6508,9537,-3029,2021,1,4,xyz,2050-01-04
6332,5572,760,2021,1,5,xyz,2050-01-05
7887,7998,-111,2021,1,6,xyz,2050-01-06
9748,8945,803,2021,1,7,xyz,2050-01-07
1811,6255,-4444,2021,1,8,xyz,2050-01-08
3034,5816,-2782,2021,1,9,xyz,2050-01-09
2499,5663,-3164,2021,1,10,xyz,2050-01-10
5374,988,4386,2021,1,11,xyz,2050-01-11
3003,8312,-5309,2021,1,12,xyz,2050-01-12
8669,2928,5741,2021,1,13,xyz,2050-01-13
2875,826,2049,2021,1,14,xyz,2050-01-14
5865,770,5095,2021,1,15,xyz,2050-01-15
2690,9688,-6998,2021,1,16,xyz,2050-01-16
4662,704,3958,2021,1,17,xyz,2050-01-17
4581,3022,1559,2021,1,18,xyz,2050-01-18
4416,6470,-2054,2021,1,19,xyz,2050-01-19
6025,2096,3929,2021,1,20,xyz,2050-01-20
1765,3619,-1854,2021,1,21,xyz,2050-01-21
2194,2398,-204,2021,1,22,xyz,2050-01-22
9481,4999,4482,2021,1,23,xyz,2050-01-23
6514,8868,-2354,2021,1,24,xyz,2050-01-24
5115,5477,-362,2021,1,25,xyz,2050-01-25
2618,3353,-735,2021,1,26,xyz,2050-01-26
4556,4092,464,2021,1,27,xyz,2050-01-27
4538,842,3696,2021,1,28,xyz,2050-01-28
1251,8391,-7140,2021,1,29,xyz,2050-01-29
1110,2595,-1485,2021,1,30,xyz,2050-01-30
9918,1868,8050,2021,1,31,xyz,2050-01-31
9803,8513,1290,2021,2,1,xyz,2050-02-01
6404,660,5744,2021,2,2,xyz,2050-02-02
3392,2022,1370,2021,2,3,xyz,2050-02-03
1291,6012,-4721,2021,2,4,xyz,2050-02-04
8599,991,7608,2021,2,5,xyz,2050-02-05
6157,4845,1312,2021,2,6,xyz,2050-02-06
7648,9789,-2141,2021,2,7,xyz,2050-02-07
9636,6377,3259,2021,2,8,xyz,2050-02-08
3857,8284,-4427,2021,2,9,xyz,2050-02-09
5049,4583,466,2021,2,10,xyz,2050-02-10
2392,2097,295,2021,2,11,xyz,2050-02-11
1322,1773,-451,2021,2,12,xyz,2050-02-12
4926,4611,315,2021,2,13,xyz,2050-02-13
5745,6158,-413,2021,2,14,xyz,2050-02-14
2083,4890,-2807,2021,2,15,xyz,2050-02-15
3695,9159,-5464,2021,2,16,xyz,2050-02-16
2529,4099,-1570,2021,2,17,xyz,2050-02-17
4278,6239,-1961,2021,2,18,xyz,2050-02-18
2474,8375,-5901,2021,2,19,xyz,2050-02-19
1937,3704,-1767,2021,2,20,xyz,2050-02-20
3353,3588,-235,2021,2,21,xyz,2050-02-21
4885,6512,-1627,2021,2,22,xyz,2050-02-22
8278,3308,4970,2021,2,23,xyz,2050-02-23
6237,1132,5105,2021,2,24,xyz,2050-02-24
4970,3734,1236,2021,2,25,xyz,2050-02-25
9394,4648,4746,2021,2,26,xyz,2050-02-26
1926,7411,-5485,2021,2,27,xyz,2050-02-27
3122,8700,-5578,2021,2,28,xyz,2050-02-28
8849,4073,4776,2021,3,1,xyz,2050-03-01
8556,6513,2043,2021,3,2,xyz,2050-03-02
9684,4584,5100,2021,3,3,xyz,2050-03-03
6803,3582,3221,2021,3,4,xyz,2050-03-04
2361,5685,-3324,2021,3,5,xyz,2050-03-05
3704,931,2773,2021,3,6,xyz,2050-03-06
9780,9269,511,2021,3,7,xyz,2050-03-07
4029,9958,-5929,2021,3,8,xyz,2050-03-08
8426,2962,5464,2021,3,9,xyz,2050-03-09
3443,4849,-1406,2021,3,10,xyz,2050-03-10
1299,4730,-3431,2021,3,11,xyz,2050-03-11
3520,7876,-4356,2021,3,12,xyz,2050-03-12
3960,8372,-4412,2021,3,13,xyz,2050-03-13
5012,5563,-551,2021,3,14,xyz,2050-03-14
8852,6096,2756,2021,3,15,xyz,2050-03-15
5675,9258,-3583,2021,3,16,xyz,2050-03-16
1816,1742,74,2021,3,17,xyz,2050-03-17
4808,9789,-4981,2021,3,18,xyz,2050-03-18
9398,4959,4439,2021,3,19,xyz,2050-03-19
4097,623,3474,2021,3,20,xyz,2050-03-20
2551,4796,-2245,2021,3,21,xyz,2050-03-21
4555,575,3980,2021,3,22,xyz,2050-03-22
8241,6780,1461,2021,3,23,xyz,2050-03-23
6631,3441,3190,2021,3,24,xyz,2050-03-24
1999,3355,-1356,2021,3,25,xyz,2050-03-25
5513,2239,3274,2021,3,26,xyz,2050-03-26
5059,1728,3331,2021,3,27,xyz,2050-03-27
3841,9078,-5237,2021,3,28,xyz,2050-03-28
6775,1075,5700,2021,3,29,xyz,2050-03-29
6145,7209,-1064,2021,3,30,xyz,2050-03-30
1947,7561,-5614,2021,3,31,xyz,2050-03-31
7030,1952,5078,2021,4,1,xyz,2050-04-01
2783,5456,-2673,2021,4,2,xyz,2050-04-02
9554,3905,5649,2021,4,3,xyz,2050-04-03
8813,8278,535,2021,4,4,xyz,2050-04-04
1932,9090,-7158,2021,4,5,xyz,2050-04-05
6495,6390,105,2021,4,6,xyz,2050-04-06
4234,5247,-1013,2021,4,7,xyz,2050-04-07
2619,1692,927,2021,4,8,xyz,2050-04-08
3704,4378,-674,2021,4,9,xyz,2050-04-09
1502,6724,-5222,2021,4,10,xyz,2050-04-10
8910,2341,6569,2021,4,11,xyz,2050-04-11
1151,2469,-1318,2021,4,12,xyz,2050-04-12
8724,1653,7071,2021,4,13,xyz,2050-04-13
2324,3088,-764,2021,4,14,xyz,2050-04-14
1848,6825,-4977,2021,4,15,xyz,2050-04-15
4479,5509,-1030,2021,4,16,xyz,2050-04-16
6848,6405,443,2021,4,17,xyz,2050-04-17
9117,8038,1079,2021,4,18,xyz,2050-04-18
1069,8476,-7407,2021,4,19,xyz,2050-04-19
4723,6730,-2007,2021,4,20,xyz,2050-04-20
4390,3181,1209,2021,4,21,xyz,2050-04-21
6203,9637,-3434,2021,4,22,xyz,2050-04-22
4931,1146,3785,2021,4,23,xyz,2050-04-23
7721,5396,2325,2021,4,24,xyz,2050-04-24
1867,7360,-5493,2021,4,25,xyz,2050-04-25
2818,4143,-1325,2021,4,26,xyz,2050-04-26
3306,3976,-670,2021,4,27,xyz,2050-04-27
1407,8137,-6730,2021,4,28,xyz,2050-04-28
3012,3663,-651,2021,4,29,xyz,2050-04-29
8066,4344,3722,2021,4,30,xyz,2050-04-30
7131,8648,-1517,2021,5,1,xyz,2050-05-01
5122,5388,-266,2021,5,2,xyz,2050-05-02
9846,1669,8177,2021,5,3,xyz,2050-05-03
1199,7901,-6702,2021,5,4,xyz,2050-05-04
3260,2051,1209,2021,5,5,xyz,2050-05-05
6942,7549,-607,2021,5,6,xyz,2050-05-06
5378,5342,36,2021,5,7,xyz,2050-05-07
9822,5832,3990,2021,5,8,xyz,2050-05-08
9750,5810,3940,2021,5,9,xyz,2050-05-09
1059,1104,-45,2021,5,10,xyz,2050-05-10
4882,5634,-752,2021,5,11,xyz,2050-05-11
4369,4798,-429,2021,5,12,xyz,2050-05-12
3909,6754,-2845,2021,5,13,xyz,2050-05-13
9703,2715,6988,2021,5,14,xyz,2050-05-14
2098,3271,-1173,2021,5,15,xyz,2050-05-15
3042,7856,-4814,2021,5,16,xyz,2050-05-16
4699,4292,407,2021,5,17,xyz,2050-05-17
8018,9656,-1638,2021,5,18,xyz,2050-05-18
7465,5525,1940,2021,5,19,xyz,2050-05-19
5683,7226,-1543,2021,5,20,xyz,2050-05-20
6619,3265,3354,2021,5,21,xyz,2050-05-21
7063,6832,231,2021,5,22,xyz,2050-05-22
4219,2164,2055,2021,5,23,xyz,2050-05-23
8019,7001,1018,2021,5,24,xyz,2050-05-24
1304,2862,-1558,2021,5,25,xyz,2050-05-25
2566,8431,-5865,2021,5,26,xyz,2050-05-26
8099,5134,2965,2021,5,27,xyz,2050-05-27
3888,1390,2498,2021,5,28,xyz,2050-05-28
3250,3644,-394,2021,5,29,xyz,2050-05-29
5854,9957,-4103,2021,5,30,xyz,2050-05-30
6877,5788,1089,2021,5,31,xyz,2050-05-31
7708,3569,4139,2021,6,1,xyz,2050-06-01
1491,4253,-2762,2021,6,2,xyz,2050-06-02
3891,8332,-4441,2021,6,3,xyz,2050-06-03
9180,8958,222,2021,6,4,xyz,2050-06-04
4098,8475,-4377,2021,6,5,xyz,2050-06-05
8009,6504,1505,2021,6,6,xyz,2050-06-06
3141,6034,-2893,2021,6,7,xyz,2050-06-07
6549,7607,-1058,2021,6,8,xyz,2050-06-08
5986,4861,1125,2021,6,9,xyz,2050-06-09
4693,6665,-1972,2021,6,10,xyz,2050-06-10
2141,8674,-6533,2021,6,11,xyz,2050-06-11
6171,6575,-404,2021,6,12,xyz,2050-06-12
4282,572,3710,2021,6,13,xyz,2050-06-13
7074,6099,975,2021,6,14,xyz,2050-06-14
7319,6426,893,2021,6,15,xyz,2050-06-15
6224,7378,-1154,2021,6,16,xyz,2050-06-16
7622,3157,4465,2021,6,17,xyz,2050-06-17
5849,4860,989,2021,6,18,xyz,2050-06-18
2312,1708,604,2021,6,19,xyz,2050-06-19
4243,5747,-1504,2021,6,20,xyz,2050-06-20
7448,8226,-778,2021,6,21,xyz,2050-06-21
2085,8082,-5997,2021,6,22,xyz,2050-06-22
4893,692,4201,2021,6,23,xyz,2050-06-23
2403,3444,-1041,2021,6,24,xyz,2050-06-24
2705,5290,-2585,2021,6,25,xyz,2050-06-25
9463,648,8815,2021,6,26,xyz,2050-06-26
2794,8269,-5475,2021,6,27,xyz,2050-06-27
3308,1543,1765,2021,6,28,xyz,2050-06-28
9633,5968,3665,2021,6,29,xyz,2050-06-29
3736,9735,-5999,2021,6,30,xyz,2050-06-30
8324,707,7617,2021,7,1,xyz,2050-07-01
8770,4559,4211,2021,7,2,xyz,2050-07-02
7302,2043,5259,2021,7,3,xyz,2050-07-03
1820,9227,-7407,2021,7,4,xyz,2050-07-04
1899,5083,-3184,2021,7,5,xyz,2050-07-05
3064,2181,883,2021,7,6,xyz,2050-07-06
4538,3122,1416,2021,7,7,xyz,2050-07-07
8101,3793,4308,2021,7,8,xyz,2050-07-08
9724,4259,5465,2021,7,9,xyz,2050-07-09
1092,8887,-7795,2021,7,10,xyz,2050-07-10
4141,9207,-5066,2021,7,11,xyz,2050-07-11
8881,2194,6687,2021,7,12,xyz,2050-07-12
3919,5579,-1660,2021,7,13,xyz,2050-07-13
4875,5857,-982,2021,7,14,xyz,2050-07-14
1822,1094,728,2021,7,15,xyz,2050-07-15
9762,6119,3643,2021,7,16,xyz,2050-07-16
4561,1516,3045,2021,7,17,xyz,2050-07-17
6530,5860,670,2021,7,18,xyz,2050-07-18
1275,8716,-7441,2021,7,19,xyz,2050-07-19
2229,3437,-1208,2021,7,20,xyz,2050-07-20
3521,2093,1428,2021,7,21,xyz,2050-07-21
8488,5751,2737,2021,7,22,xyz,2050-07-22
5346,9917,-4571,2021,7,23,xyz,2050-07-23
7806,3094,4712,2021,7,24,xyz,2050-07-24
6837,5218,1619,2021,7,25,xyz,2050-07-25
4896,5191,-295,2021,7,26,xyz,2050-07-26
3947,1953,1994,2021,7,27,xyz,2050-07-27
8164,2952,5212,2021,7,28,xyz,2050-07-28
7418,5410,2008,2021,7,29,xyz,2050-07-29
5077,3678,1399,2021,7,30,xyz,2050-07-30
3926,7682,-3756,2021,7,31,xyz,2050-07-31
1809,8898,-7089,2021,8,1,xyz,2050-08-01
6431,6330,101,2021,8,2,xyz,2050-08-02
1536,1527,9,2021,8,3,xyz,2050-08-03
6766,2079,4687,2021,8,4,xyz,2050-08-04
7925,6989,936,2021,8,5,xyz,2050-08-05
9616,6428,3188,2021,8,6,xyz,2050-08-06
8263,1860,6403,2021,8,7,xyz,2050-08-07
6600,9132,-2532,2021,8,8,xyz,2050-08-08
6096,6986,-890,2021,8,9,xyz,2050-08-09
4835,6246,-1411,2021,8,10,xyz,2050-08-10
1734,4194,-2460,2021,8,11,xyz,2050-08-11
2420,3981,-1561,2021,8,12,xyz,2050-08-12
2084,3257,-1173,2021,8,13,xyz,2050-08-13
3193,9163,-5970,2021,8,14,xyz,2050-08-14
4249,8912,-4663,2021,8,15,xyz,2050-08-15
5214,1250,3964,2021,8,16,xyz,2050-08-16
6376,2643,3733,2021,8,17,xyz,2050-08-17
1755,5270,-3515,2021,8,18,xyz,2050-08-18
5710,6505,-795,2021,8,19,xyz,2050-08-19
1842,3793,-1951,2021,8,20,xyz,2050-08-20
1374,9325,-7951,2021,8,21,xyz,2050-08-21
4607,8776,-4169,2021,8,22,xyz,2050-08-22
9814,7672,2142,2021,8,23,xyz,2050-08-23
1391,5660,-4269,2021,8,24,xyz,2050-08-24
7231,5617,1614,2021,8,25,xyz,2050-08-25
5675,4491,1184,2021,8,26,xyz,2050-08-26
5466,4261,1205,2021,8,27,xyz,2050-08-27
6070,5464,606,2021,8,28,xyz,2050-08-28
7501,7702,-201,2021,8,29,xyz,2050-08-29
6711,9939,-3228,2021,8,30,xyz,2050-08-30
9038,7128,1910,2021,8,31,xyz,2050-08-31
9863,1167,8696,2021,9,1,xyz,2050-09-01
2864,9847,-6983,2021,9,2,xyz,2050-09-02
2512,1477,1035,2021,9,3,xyz,2050-09-03
8666,2931,5735,2021,9,4,xyz,2050-09-04
1806,931,875,2021,9,5,xyz,2050-09-05
3768,3378,390,2021,9,6,xyz,2050-09-06
6459,9454,-2995,2021,9,7,xyz,2050-09-07
4589,3349,1240,2021,9,8,xyz,2050-09-08
4792,1427,3365,2021,9,9,xyz,2050-09-09
1261,7597,-6336,2021,9,10,xyz,2050-09-10
5807,7612,-1805,2021,9,11,xyz,2050-09-11
4036,879,3157,2021,9,12,xyz,2050-09-12
4343,840,3503,2021,9,13,xyz,2050-09-13
7510,8513,-1003,2021,9,14,xyz,2050-09-14
2239,7438,-5199,2021,9,15,xyz,2050-09-15
2663,7649,-4986,2021,9,16,xyz,2050-09-16
3044,7021,-3977,2021,9,17,xyz,2050-09-17
7535,7201,334,2021,9,18,xyz,2050-09-18
1855,1052,803,2021,9,19,xyz,2050-09-19
9988,1756,8232,2021,9,20,xyz,2050-09-20
5417,3912,1505,2021,9,21,xyz,2050-09-21
1899,5224,-3325,2021,9,22,xyz,2050-09-22
1637,2297,-660,2021,9,23,xyz,2050-09-23
6328,8874,-2546,2021,9,24,xyz,2050-09-24
3782,3535,247,2021,9,25,xyz,2050-09-25
6942,3029,3913,2021,9,26,xyz,2050-09-26
5370,2631,2739,2021,9,27,xyz,2050-09-27
3649,6302,-2653,2021,9,28,xyz,2050-09-28
3464,6093,-2629,2021,9,29,xyz,2050-09-29
4720,1002,3718,2021,9,30,xyz,2050-09-30
3486,4152,-666,2021,10,1,xyz,2050-10-01
5594,612,4982,2021,10,2,xyz,2050-10-02
9700,695,9005,2021,10,3,xyz,2050-10-03
2200,6506,-4306,2021,10,4,xyz,2050-10-04
2708,8111,-5403,2021,10,5,xyz,2050-10-05
7623,9263,-1640,2021,10,6,xyz,2050-10-06
1522,5356,-3834,2021,10,7,xyz,2050-10-07
8330,8551,-221,2021,10,8,xyz,2050-10-08
3149,1878,1271,2021,10,9,xyz,2050-10-09
3157,1255,1902,2021,10,10,xyz,2050-10-10
6520,3045,3475,2021,10,11,xyz,2050-10-11
5480,842,4638,2021,10,12,xyz,2050-10-12
6189,5034,1155,2021,10,13,xyz,2050-10-13
1249,7882,-6633,2021,10,14,xyz,2050-10-14
8822,9746,-924,2021,10,15,xyz,2050-10-15
7347,6560,787,2021,10,16,xyz,2050-10-16
6842,7195,-353,2021,10,17,xyz,2050-10-17
8867,4235,4632,2021,10,18,xyz,2050-10-18
1162,9410,-8248,2021,10,19,xyz,2050-10-19
4210,7805,-3595,2021,10,20,xyz,2050-10-20
1812,8912,-7100,2021,10,21,xyz,2050-10-21
6216,5909,307,2021,10,22,xyz,2050-10-22
6185,8079,-1894,2021,10,23,xyz,2050-10-23
8394,9427,-1033,2021,10,24,xyz,2050-10-24
7441,4064,3377,2021,10,25,xyz,2050-10-25
7775,3127,4648,2021,10,26,xyz,2050-10-26
5334,1112,4222,2021,10,27,xyz,2050-10-27
1905,6040,-4135,2021,10,28,xyz,2050-10-28
3622,1355,2267,2021,10,29,xyz,2050-10-29
7063,7029,34,2021,10,30,xyz,2050-10-30
5282,4175,1107,2021,10,31,xyz,2050-10-31
8747,8059,688,2021,11,1,xyz,2050-11-01
4883,1569,3314,2021,11,2,xyz,2050-11-02
3331,9864,-6533,2021,11,3,xyz,2050-11-03
8410,7513,897,2021,11,4,xyz,2050-11-04
1402,806,596,2021,11,5,xyz,2050-11-05
8080,5169,2911,2021,11,6,xyz,2050-11-06
1464,554,910,2021,11,7,xyz,2050-11-07
8278,6121,2157,2021,11,8,xyz,2050-11-08
2406,4592,-2186,2021,11,9,xyz,2050-11-09
2697,6141,-3444,2021,11,10,xyz,2050-11-10
8320,4105,4215,2021,11,11,xyz,2050-11-11
6368,8407,-2039,2021,11,12,xyz,2050-11-12
3113,3996,-883,2021,11,13,xyz,2050-11-13
9754,2114,7640,2021,11,14,xyz,2050-11-14
6545,2324,4221,2021,11,15,xyz,2050-11-15
5819,6634,-815,2021,11,16,xyz,2050-11-16
3619,6380,-2761,2021,11,17,xyz,2050-11-17
7941,8281,-340,2021,11,18,xyz,2050-11-18
8121,5132,2989,2021,11,19,xyz,2050-11-19
9420,7140,2280,2021,11,20,xyz,2050-11-20
6261,9041,-2780,2021,11,21,xyz,2050-11-21
5159,9855,-4696,2021,11,22,xyz,2050-11-22
7728,6365,1363,2021,11,23,xyz,2050-11-23
2301,4481,-2180,2021,11,24,xyz,2050-11-24
7888,1600,6288,2021,11,25,xyz,2050-11-25
6325,8189,-1864,2021,11,26,xyz,2050-11-26
6323,2696,3627,2021,11,27,xyz,2050-11-27
3588,4778,-1190,2021,11,28,xyz,2050-11-28
6160,7378,-1218,2021,11,29,xyz,2050-11-29
4327,1271,3056,2021,11,30,xyz,2050-11-30
4181,2672,1509,2021,12,1,xyz,2050-12-01
8658,8885,-227,2021,12,2,xyz,2050-12-02
5626,8902,-3276,2021,12,3,xyz,2050-12-03
5973,4705,1268,2021,12,4,xyz,2050-12-04
7074,8213,-1139,2021,12,5,xyz,2050-12-05
4125,5049,-924,2021,12,6,xyz,2050-12-06
7157,5374,1783,2021,12,7,xyz,2050-12-07
4049,5323,-1274,2021,12,8,xyz,2050-12-08
1425,9696,-8271,2021,12,9,xyz,2050-12-09
1904,8828,-6924,2021,12,10,xyz,2050-12-10
1192,4496,-3304,2021,12,11,xyz,2050-12-11
2268,5717,-3449,2021,12,12,xyz,2050-12-12
4813,5514,-701,2021,12,13,xyz,2050-12-13
4366,6798,-2432,2021,12,14,xyz,2050-12-14
4308,6079,-1771,2021,12,15,xyz,2050-12-15
2750,2111,639,2021,12,16,xyz,2050-12-16
1379,6266,-4887,2021,12,17,xyz,2050-12-17
2412,8001,-5589,2021,12,18,xyz,2050-12-18
1084,1133,-49,2021,12,19,xyz,2050-12-19
8193,9328,-1135,2021,12,20,xyz,2050-12-20
4491,4174,317,2021,12,21,xyz,2050-12-21
5264,3578,1686,2021,12,22,xyz,2050-12-22
6581,3920,2661,2021,12,23,xyz,2050-12-23
1906,8319,-6413,2021,12,24,xyz,2050-12-24
8457,4947,3510,2021,12,25,xyz,2050-12-25
2237,546,1691,2021,12,26,xyz,2050-12-26
9814,524,9290,2021,12,27,xyz,2050-12-27
3700,1321,2379,2021,12,28,xyz,2050-12-28
3954,5160,-1206,2021,12,29,xyz,2050-12-29
2251,6021,-3770,2021,12,30,xyz,2050-12-30
6884,7688,-804,2021,12,31,xyz,2050-12-31
4761,9929,-5168,2022,1,1,xyz,2051-01-01
8962,6573,2389,2022,1,2,xyz,2051-01-02
9285,3165,6120,2022,1,3,xyz,2051-01-03
2697,1279,1418,2022,1,4,xyz,2051-01-04
4862,9835,-4973,2022,1,5,xyz,2051-01-05
9657,3939,5718,2022,1,6,xyz,2051-01-06
1730,2967,-1237,2022,1,7,xyz,2051-01-07
9819,6976,2843,2022,1,8,xyz,2051-01-08
4277,1932,2345,2022,1,9,xyz,2051-01-09
4358,7589,-3231,2022,1,10,xyz,2051-01-10
4664,978,3686,2022,1,11,xyz,2051-01-11
5700,3561,2139,2022,1,12,xyz,2051-01-12
1096,4261,-3165,2022,1,13,xyz,2051-01-13
6152,6308,-156,2022,1,14,xyz,2051-01-14
4573,6270,-1697,2022,1,15,xyz,2051-01-15
4139,2223,1916,2022,1,16,xyz,2051-01-16
7682,8863,-1181,2022,1,17,xyz,2051-01-17
1582,1626,-44,2022,1,18,xyz,2051-01-18
5707,9067,-3360,2022,1,19,xyz,2051-01-19
5613,8514,-2901,2022,1,20,xyz,2051-01-20
7866,8427,-561,2022,1,21,xyz,2051-01-21
2201,5026,-2825,2022,1,22,xyz,2051-01-22
9016,1398,7618,2022,1,23,xyz,2051-01-23
3912,9007,-5095,2022,1,24,xyz,2051-01-24
7582,7375,207,2022,1,25,xyz,2051-01-25
3104,1010,2094,2022,1,26,xyz,2051-01-26
4908,5685,-777,2022,1,27,xyz,2051-01-27
3417,7043,-3626,2022,1,28,xyz,2051-01-28
7761,4005,3756,2022,1,29,xyz,2051-01-29
1886,3316,-1430,2022,1,30,xyz,2051-01-30
4623,7117,-2494,2022,1,31,xyz,2051-01-31
2819,1552,1267,2022,2,1,xyz,2051-02-01
2885,3139,-254,2022,2,2,xyz,2051-02-02
3891,7467,-3576,2022,2,3,xyz,2051-02-03
6459,3160,3299,2022,2,4,xyz,2051-02-04
4809,9899,-5090,2022,2,5,xyz,2051-02-05
2096,6308,-4212,2022,2,6,xyz,2051-02-06
3539,7645,-4106,2022,2,7,xyz,2051-02-07
7650,1406,6244,2022,2,8,xyz,2051-02-08
7736,5208,2528,2022,2,9,xyz,2051-02-09
3347,2811,536,2022,2,10,xyz,2051-02-10
8302,3180,5122,2022,2,11,xyz,2051-02-11
6820,1355,5465,2022,2,12,xyz,2051-02-12
8920,2261,6659,2022,2,13,xyz,2051-02-13
4042,2074,1968,2022,2,14,xyz,2051-02-14
5100,7238,-2138,2022,2,15,xyz,2051-02-15
8648,541,8107,2022,2,16,xyz,2051-02-16
6430,7141,-711,2022,2,17,xyz,2051-02-17
3623,2022,1601,2022,2,18,xyz,2051-02-18
6310,7757,-1447,2022,2,19,xyz,2051-02-19
5056,6781,-1725,2022,2,20,xyz,2051-02-20
1703,2900,-1197,2022,2,21,xyz,2051-02-21
1134,6510,-5376,2022,2,22,xyz,2051-02-22
5757,1021,4736,2022,2,23,xyz,2051-02-23
5018,2739,2279,2022,2,24,xyz,2051-02-24
1433,645,788,2022,2,25,xyz,2051-02-25
4710,6401,-1691,2022,2,26,xyz,2051-02-26
5803,9999,-4196,2022,2,27,xyz,2051-02-27
9487,3848,5639,2022,2,28,xyz,2051-02-28
2541,6894,-4353,2022,3,1,xyz,2051-03-01
4308,5742,-1434,2022,3,2,xyz,2051-03-02
9123,1787,7336,2022,3,3,xyz,2051-03-03
7609,4745,2864,2022,3,4,xyz,2051-03-04
1967,6623,-4656,2022,3,5,xyz,2051-03-05
7460,7892,-432,2022,3,6,xyz,2051-03-06
5877,8718,-2841,2022,3,7,xyz,2051-03-07
2500,5614,-3114,2022,3,8,xyz,2051-03-08
5542,8031,-2489,2022,3,9,xyz,2051-03-09
8307,5107,3200,2022,3,10,xyz,2051-03-10
4167,7394,-3227,2022,3,11,xyz,2051-03-11
2808,1596,1212,2022,3,12,xyz,2051-03-12
9287,4362,4925,2022,3,13,xyz,2051-03-13
7044,3902,3142,2022,3,14,xyz,2051-03-14
6050,6221,-171,2022,3,15,xyz,2051-03-15
7231,4642,2589,2022,3,16,xyz,2051-03-16
2898,3822,-924,2022,3,17,xyz,2051-03-17
2381,1183,1198,2022,3,18,xyz,2051-03-18
2486,9916,-7430,2022,3,19,xyz,2051-03-19
6523,2679,3844,2022,3,20,xyz,2051-03-20
8329,5624,2705,2022,3,21,xyz,2051-03-21
1709,5776,-4067,2022,3,22,xyz,2051-03-22
7099,6983,116,2022,3,23,xyz,2051-03-23
3235,9091,-5856,2022,3,24,xyz,2051-03-24
1624,786,838,2022,3,25,xyz,2051-03-25
9758,9155,603,2022,3,26,xyz,2051-03-26
8514,2380,6134,2022,3,27,xyz,2051-03-27
9441,9640,-199,2022,3,28,xyz,2051-03-28
8465,4354,4111,2022,3,29,xyz,2051-03-29
7805,3915,3890,2022,3,30,xyz,2051-03-30
9934,7696,2238,2022,3,31,xyz,2051-03-31
5242,6178,-936,2022,4,1,xyz,2051-04-01
5136,1088,4048,2022,4,2,xyz,2051-04-02
6818,1584,5234,2022,4,3,xyz,2051-04-03
8772,2799,5973,2022,4,4,xyz,2051-04-04
7986,9799,-1813,2022,4,5,xyz,2051-04-05
1651,2536,-885,2022,4,6,xyz,2051-04-06
6379,5831,548,2022,4,7,xyz,2051-04-07
1817,860,957,2022,4,8,xyz,2051-04-08
2221,7489,-5268,2022,4,9,xyz,2051-04-09
2372,5323,-2951,2022,4,10,xyz,2051-04-10
6184,2219,3965,2022,4,11,xyz,2051-04-11
2971,7273,-4302,2022,4,12,xyz,2051-04-12
7323,513,6810,2022,4,13,xyz,2051-04-13
5181,7380,-2199,2022,4,14,xyz,2051-04-14
1748,1706,42,2022,4,15,xyz,2051-04-15
4997,5566,-569,2022,4,16,xyz,2051-04-16
4169,4495,-326,2022,4,17,xyz,2051-04-17
6326,8031,-1705,2022,4,18,xyz,2051-04-18
3209,8753,-5544,2022,4,19,xyz,2051-04-19
2260,7965,-5705,2022,4,20,xyz,2051-04-20
1536,9217,-7681,2022,4,21,xyz,2051-04-21
3978,5684,-1706,2022,4,22,xyz,2051-04-22
9779,7774,2005,2022,4,23,xyz,2051-04-23
3496,3574,-78,2022,4,24,xyz,2051-04-24
6838,1289,5549,2022,4,25,xyz,2051-04-25
7138,4012,3126,2022,4,26,xyz,2051-04-26
3251,4615,-1364,2022,4,27,xyz,2051-04-27
4383,3090,1293,2022,4,28,xyz,2051-04-28
1130,4959,-3829,2022,4,29,xyz,2051-04-29
1827,7096,-5269,2022,4,30,xyz,2051-04-30
7882,5649,2233,2022,5,1,xyz,2051-05-01
8831,6608,2223,2022,5,2,xyz,2051-05-02
2145,3160,-1015,2022,5,3,xyz,2051-05-03
1117,5341,-4224,2022,5,4,xyz,2051-05-04
7089,6565,524,2022,5,5,xyz,2051-05-05
8271,4682,3589,2022,5,6,xyz,2051-05-06
2969,8291,-5322,2022,5,7,xyz,2051-05-07
3530,8318,-4788,2022,5,8,xyz,2051-05-08
8443,6740,1703,2022,5,9,xyz,2051-05-09
6825,3382,3443,2022,5,10,xyz,2051-05-10
9711,5421,4290,2022,5,11,xyz,2051-05-11
9366,6587,2779,2022,5,12,xyz,2051-05-12
4646,815,3831,2022,5,13,xyz,2051-05-13
6139,4624,1515,2022,5,14,xyz,2051-05-14
6834,9418,-2584,2022,5,15,xyz,2051-05-15
1376,3618,-2242,2022,5,16,xyz,2051-05-16
4313,1486,2827,2022,5,17,xyz,2051-05-17
3862,6366,-2504,2022,5,18,xyz,2051-05-18
2299,7150,-4851,2022,5,19,xyz,2051-05-19
1426,2299,-873,2022,5,20,xyz,2051-05-20
5334,9854,-4520,2022,5,21,xyz,2051-05-21
3309,4847,-1538,2022,5,22,xyz,2051-05-22
3517,1703,1814,2022,5,23,xyz,2051-05-23
5949,4852,1097,2022,5,24,xyz,2051-05-24
1913,3460,-1547,2022,5,25,xyz,2051-05-25
6276,6504,-228,2022,5,26,xyz,2051-05-26
2427,1999,428,2022,5,27,xyz,2051-05-27
7819,2108,5711,2022,5,28,xyz,2051-05-28
3908,8483,-4575,2022,5,29,xyz,2051-05-29
5279,3414,1865,2022,5,30,xyz,2051-05-30
5134,8194,-3060,2022,5,31,xyz,2051-05-31
3437,9711,-6274,2022,6,1,xyz,2051-06-01
2598,9567,-6969,2022,6,2,xyz,2051-06-02
1256,3779,-2523,2022,6,3,xyz,2051-06-03
2917,6522,-3605,2022,6,4,xyz,2051-06-04
7865,8929,-1064,2022,6,5,xyz,2051-06-05
2211,3728,-1517,2022,6,6,xyz,2051-06-06
3525,6583,-3058,2022,6,7,xyz,2051-06-07
6748,1748,5000,2022,6,8,xyz,2051-06-08
7372,1643,5729,2022,6,9,xyz,2051-06-09
5378,2508,2870,2022,6,10,xyz,2051-06-10
4194,8710,-4516,2022,6,11,xyz,2051-06-11
4772,3940,832,2022,6,12,xyz,2051-06-12
3613,7276,-3663,2022,6,13,xyz,2051-06-13
9376,963,8413,2022,6,14,xyz,2051-06-14
3879,9718,-5839,2022,6,15,xyz,2051-06-15
7549,5776,1773,2022,6,16,xyz,2051-06-16
9907,1112,8795,2022,6,17,xyz,2051-06-17
7298,9791,-2493,2022,6,18,xyz,2051-06-18
1097,4052,-2955,2022,6,19,xyz,2051-06-19
6687,7279,-592,2022,6,20,xyz,2051-06-20
6288,2342,3946,2022,6,21,xyz,2051-06-21
7021,4535,2486,2022,6,22,xyz,2051-06-22
5647,5594,53,2022,6,23,xyz,2051-06-23
6168,4952,1216,2022,6,24,xyz,2051-06-24
2661,7850,-5189,2022,6,25,xyz,2051-06-25
6618,4437,2181,2022,6,26,xyz,2051-06-26
2722,8140,-5418,2022,6,27,xyz,2051-06-27
4023,1834,2189,2022,6,28,xyz,2051-06-28
3038,7863,-4825,2022,6,29,xyz,2051-06-29
3969,3297,672,2022,6,30,xyz,2051-06-30
2663,1564,1099,2022,7,1,xyz,2051-07-01
7536,2712,4824,2022,7,2,xyz,2051-07-02
5113,3448,1665,2022,7,3,xyz,2051-07-03
6626,7441,-815,2022,7,4,xyz,2051-07-04
5551,9251,-3700,2022,7,5,xyz,2051-07-05
4575,9311,-4736,2022,7,6,xyz,2051-07-06
9863,3779,6084,2022,7,7,xyz,2051-07-07
8088,562,7526,2022,7,8,xyz,2051-07-08
9201,1290,7911,2022,7,9,xyz,2051-07-09
9582,9220,362,2022,7,10,xyz,2051-07-10
5997,4471,1526,2022,7,11,xyz,2051-07-11
1753,940,813,2022,7,12,xyz,2051-07-12
2343,2814,-471,2022,7,13,xyz,2051-07-13
6005,1180,4825,2022,7,14,xyz,2051-07-14
3000,2868,132,2022,7,15,xyz,2051-07-15
9047,9000,47,2022,7,16,xyz,2051-07-16
2420,7682,-5262,2022,7,17,xyz,2051-07-17
2947,6275,-3328,2022,7,18,xyz,2051-07-18
4956,7340,-2384,2022,7,19,xyz,2051-07-19
9168,3780,5388,2022,7,20,xyz,2051-07-20
9315,2496,6819,2022,7,21,xyz,2051-07-21
2110,3681,-1571,2022,7,22,xyz,2051-07-22
9137,7884,1253,2022,7,23,xyz,2051-07-23
5402,9942,-4540,2022,7,24,xyz,2051-07-24
9654,8885,769,2022,7,25,xyz,2051-07-25
4945,9044,-4099,2022,7,26,xyz,2051-07-26
8320,4930,3390,2022,7,27,xyz,2051-07-27
1275,3945,-2670,2022,7,28,xyz,2051-07-28
1377,1906,-529,2022,7,29,xyz,2051-07-29
9256,3925,5331,2022,7,30,xyz,2051-07-30
1818,8807,-6989,2022,7,31,xyz,2051-07-31
6896,8276,-1380,2022,8,1,xyz,2051-08-01
5767,5403,364,2022,8,2,xyz,2051-08-02
3507,3158,349,2022,8,3,xyz,2051-08-03
2658,7622,-4964,2022,8,4,xyz,2051-08-04
3439,4433,-994,2022,8,5,xyz,2051-08-05
4107,4792,-685,2022,8,6,xyz,2051-08-06
5684,1938,3746,2022,8,7,xyz,2051-08-07
1678,9628,-7950,2022,8,8,xyz,2051-08-08
4695,7842,-3147,2022,8,9,xyz,2051-08-09
1567,6140,-4573,2022,8,10,xyz,2051-08-10
7717,1250,6467,2022,8,11,xyz,2051-08-11
2671,6854,-4183,2022,8,12,xyz,2051-08-12
1191,6467,-5276,2022,8,13,xyz,2051-08-13
9788,8677,1111,2022,8,14,xyz,2051-08-14
8964,1194,7770,2022,8,15,xyz,2051-08-15
8247,6564,1683,2022,8,16,xyz,2051-08-16
2749,6606,-3857,2022,8,17,xyz,2051-08-17
3072,1636,1436,2022,8,18,xyz,2051-08-18
2033,5786,-3753,2022,8,19,xyz,2051-08-19
1784,8356,-6572,2022,8,20,xyz,2051-08-20
7540,8969,-1429,2022,8,21,xyz,2051-08-21
6989,1874,5115,2022,8,22,xyz,2051-08-22
9297,3418,5879,2022,8,23,xyz,2051-08-23
8566,2534,6032,2022,8,24,xyz,2051-08-24
3476,9226,-5750,2022,8,25,xyz,2051-08-25
2141,5585,-3444,2022,8,26,xyz,2051-08-26
7144,1792,5352,2022,8,27,xyz,2051-08-27
7384,3332,4052,2022,8,28,xyz,2051-08-28
7190,9562,-2372,2022,8,29,xyz,2051-08-29
8057,6812,1245,2022,8,30,xyz,2051-08-30
1426,7755,-6329,2022,8,31,xyz,2051-08-31
5693,8102,-2409,2022,9,1,xyz,2051-09-01
6044,1226,4818,2022,9,2,xyz,2051-09-02
4453,5233,-780,2022,9,3,xyz,2051-09-03
9487,8114,1373,2022,9,4,xyz,2051-09-04
4532,6817,-2285,2022,9,5,xyz,2051-09-05
9572,7380,2192,2022,9,6,xyz,2051-09-06
5106,1361,3745,2022,9,7,xyz,2051-09-07
8684,1902,6782,2022,9,8,xyz,2051-09-08
2909,7542,-4633,2022,9,9,xyz,2051-09-09
2309,7711,-5402,2022,9,10,xyz,2051-09-10
4639,9012,-4373,2022,9,11,xyz,2051-09-11
3055,4574,-1519,2022,9,12,xyz,2051-09-12
7088,4775,2313,2022,9,13,xyz,2051-09-13
8397,5672,2725,2022,9,14,xyz,2051-09-14
8153,1924,6229,2022,9,15,xyz,2051-09-15
7260,8280,-1020,2022,9,16,xyz,2051-09-16
5987,6887,-900,2022,9,17,xyz,2051-09-17
1638,623,1015,2022,9,18,xyz,2051-09-18
6645,8883,-2238,2022,9,19,xyz,2051-09-19
8870,3625,5245,2022,9,20,xyz,2051-09-20
2791,1456,1335,2022,9,21,xyz,2051-09-21
3783,8725,-4942,2022,9,22,xyz,2051-09-22
7636,1213,6423,2022,9,23,xyz,2051-09-23
1414,6624,-5210,2022,9,24,xyz,2051-09-24
3365,2982,383,2022,9,25,xyz,2051-09-25
6840,8799,-1959,2022,9,26,xyz,2051-09-26
7182,3196,3986,2022,9,27,xyz,2051-09-27
9411,5929,3482,2022,9,28,xyz,2051-09-28
3982,846,3136,2022,9,29,xyz,2051-09-29
3963,2769,1194,2022,9,30,xyz,2051-09-30
7843,9941,-2098,2022,10,1,xyz,2051-10-01
8881,5305,3576,2022,10,2,xyz,2051-10-02
3870,6983,-3113,2022,10,3,xyz,2051-10-03
8220,3512,4708,2022,10,4,xyz,2051-10-04
7004,9303,-2299,2022,10,5,xyz,2051-10-05
8662,4809,3853,2022,10,6,xyz,2051-10-06
2436,5134,-2698,2022,10,7,xyz,2051-10-07
3559,7836,-4277,2022,10,8,xyz,2051-10-08
6611,8911,-2300,2022,10,9,xyz,2051-10-09
2681,4044,-1363,2022,10,10,xyz,2051-10-10
8156,4010,4146,2022,10,11,xyz,2051-10-11
9221,1406,7815,2022,10,12,xyz,2051-10-12
5751,6853,-1102,2022,10,13,xyz,2051-10-13
1009,566,443,2022,10,14,xyz,2051-10-14
3908,6526,-2618,2022,10,15,xyz,2051-10-15
2836,7427,-4591,2022,10,16,xyz,2051-10-16
4901,7500,-2599,2022,10,17,xyz,2051-10-17
4116,5927,-1811,2022,10,18,xyz,2051-10-18
3226,4440,-1214,2022,10,19,xyz,2051-10-19
1959,1614,345,2022,10,20,xyz,2051-10-20
2399,7144,-4745,2022,10,21,xyz,2051-10-21
9363,7095,2268,2022,10,22,xyz,2051-10-22
6744,8469,-1725,2022,10,23,xyz,2051-10-23
3476,9782,-6306,2022,10,24,xyz,2051-10-24
8320,1074,7246,2022,10,25,xyz,2051-10-25
7826,4245,3581,2022,10,26,xyz,2051-10-26
8675,8015,660,2022,10,27,xyz,2051-10-27
8963,4644,4319,2022,10,28,xyz,2051-10-28
9527,9367,160,2022,10,29,xyz,2051-10-29
4067,6393,-2326,2022,10,30,xyz,2051-10-30
3210,7833,-4623,2022,10,31,xyz,2051-10-31
6423,1208,5215,2022,11,1,xyz,2051-11-01
1044,1405,-361,2022,11,2,xyz,2051-11-02
2508,4432,-1924,2022,11,3,xyz,2051-11-03
4690,591,4099,2022,11,4,xyz,2051-11-04
2736,4263,-1527,2022,11,5,xyz,2051-11-05
2611,7880,-5269,2022,11,6,xyz,2051-11-06
9002,5901,3101,2022,11,7,xyz,2051-11-07
1304,8906,-7602,2022,11,8,xyz,2051-11-08
9106,4320,4786,2022,11,9,xyz,2051-11-09
8631,1521,7110,2022,11,10,xyz,2051-11-10
7302,6034,1268,2022,11,11,xyz,2051-11-11
4817,9600,-4783,2022,11,12,xyz,2051-11-12
3317,815,2502,2022,11,13,xyz,2051-11-13
5019,2885,2134,2022,11,14,xyz,2051-11-14
9975,2606,7369,2022,11,15,xyz,2051-11-15
8435,3201,5234,2022,11,16,xyz,2051-11-16
6254,6221,33,2022,11,17,xyz,2051-11-17
2602,5886,-3284,2022,11,18,xyz,2051-11-18
1768,7496,-5728,2022,11,19,xyz,2051-11-19
5906,6188,-282,2022,11,20,xyz,2051-11-20
8506,8235,271,2022,11,21,xyz,2051-11-21
3516,4477,-961,2022,11,22,xyz,2051-11-22
5624,6001,-377,2022,11,23,xyz,2051-11-23
8770,7040,1730,2022,11,24,xyz,2051-11-24
3765,1943,1822,2022,11,25,xyz,2051-11-25
2970,3254,-284,2022,11,26,xyz,2051-11-26
7123,3432,3691,2022,11,27,xyz,2051-11-27
6373,5517,856,2022,11,28,xyz,2051-11-28
4001,2426,1575,2022,11,29,xyz,2051-11-29
6088,9884,-3796,2022,11,30,xyz,2051-11-30
7668,8255,-587,2022,12,1,xyz,2051-12-01
1243,2966,-1723,2022,12,2,xyz,2051-12-02
1145,7026,-5881,2022,12,3,xyz,2051-12-03
9733,2759,6974,2022,12,4,xyz,2051-12-04
9923,5122,4801,2022,12,5,xyz,2051-12-05
1547,3166,-1619,2022,12,6,xyz,2051-12-06
5287,1939,3348,2022,12,7,xyz,2051-12-07
1928,1918,10,2022,12,8,xyz,2051-12-08
4530,9237,-4707,2022,12,9,xyz,2051-12-09
5073,7416,-2343,2022,12,10,xyz,2051-12-10
4980,4128,852,2022,12,11,xyz,2051-12-11
1353,8081,-6728,2022,12,12,xyz,2051-12-12
8564,8179,385,2022,12,13,xyz,2051-12-13
4442,3016,1426,2022,12,14,xyz,2051-12-14
4727,3683,1044,2022,12,15,xyz,2051-12-15
7175,6269,906,2022,12,16,xyz,2051-12-16
3105,932,2173,2022,12,17,xyz,2051-12-17
5735,1274,4461,2022,12,18,xyz,2051-12-18
8477,9214,-737,2022,12,19,xyz,2051-12-19
2112,9840,-7728,2022,12,20,xyz,2051-12-20
1268,8942,-7674,2022,12,21,xyz,2051-12-21
4267,4269,-2,2022,12,22,xyz,2051-12-22
9887,9794,93,2022,12,23,xyz,2051-12-23
9551,7426,2125,2022,12,24,xyz,2051-12-24
4440,7996,-3556,2022,12,25,xyz,2051-12-25
8254,1519,6735,2022,12,26,xyz,2051-12-26
9988,4140,5848,2022,12,27,xyz,2051-12-27
3055,5517,-2462,2022,12,28,xyz,2051-12-28
1270,9944,-8674,2022,12,29,xyz,2051-12-29
2017,6504,-4487,2022,12,30,xyz,2051-12-30
1923,9473,-7550,2022,12,31,xyz,2051-12-31
1095,5618,-4523,2023,1,1,xyz,2052-01-01
9724,2216,7508,2023,1,2,xyz,2052-01-02
8691,6035,2656,2023,1,3,xyz,2052-01-03
7050,8115,-1065,2023,1,4,xyz,2052-01-04
7074,686,6388,2023,1,5,xyz,2052-01-05
4253,9662,-5409,2023,1,6,xyz,2052-01-06
9084,5103,3981,2023,1,7,xyz,2052-01-07
8058,4490,3568,2023,1,8,xyz,2052-01-08
7587,7419,168,2023,1,9,xyz,2052-01-09
4103,3681,422,2023,1,10,xyz,2052-01-10
1818,3966,-2148,2023,1,11,xyz,2052-01-11
9558,7536,2022,2023,1,12,xyz,2052-01-12
1850,7881,-6031,2023,1,13,xyz,2052-01-13
6923,2647,4276,2023,1,14,xyz,2052-01-14
8939,3361,5578,2023,1,15,xyz,2052-01-15
9649,9761,-112,2023,1,16,xyz,2052-01-16
2491,2160,331,2023,1,17,xyz,2052-01-17
4484,9453,-4969,2023,1,18,xyz,2052-01-18
7669,8287,-618,2023,1,19,xyz,2052-01-19
9850,3845,6005,2023,1,20,xyz,2052-01-20
7405,6404,1001,2023,1,21,xyz,2052-01-21
8899,1244,7655,2023,1,22,xyz,2052-01-22
7860,2160,5700,2023,1,23,xyz,2052-01-23
8194,7136,1058,2023,1,24,xyz,2052-01-24
5870,5439,431,2023,1,25,xyz,2052-01-25
3732,3858,-126,2023,1,26,xyz,2052-01-26
